"movie_id","title","year","video","picture","all_critics_tomatometer","all_critics_average_rating","all_critics_reviews_counted","all_critics_fresh","all_critics_rotten","consensus","audience_score","user_ratings","top_critics_tomatometer","top_critics_average_rating","top_critics_reviews_counted","top_critics_fresh","top_critics_rotten"
101,"Protector (Protektor)",1997,"https://www.youtube.com/embed/MaI-4NepPfU","http://pictify.saatchigallery.com/files/works/chagall-vitraux-pour-jerusalem-poster-chagall-la-tribu-de-1363528645.jpg",95,3.2,5542,3371,2171,"Duis aliquam convallis nunc. Proin at turpis a pede posuere nonummy. Integer non velit.",64,1379,57,1,2016,3074,-1058
102,"Isolation",2012,"https://www.youtube.com/embed/ee12SvnnrSw","https://encrypted-tbn0.gstatic.com/images?q=tbn:ANd9GcQ_K_OlRU89USb4Vi53WsTFwqiEXKhfRUVw08lWTiH5XSmSISDDwg",26,7,7393,7659,-266,"Proin eu mi. Nulla ac enim. In tempor, turpis nec euismod scelerisque, quam turpis adipiscing lorem, vitae mattis nibh ligula nec sem.",30,9857,4,1.1,4108,3371,737
103,"The Indian Runner",2006,"https://www.youtube.com/embed/B12REtkl2KY","https://encrypted-tbn0.gstatic.com/images?q=tbn:ANd9GcRUlnvuLTJg0mT65nGxwZY6OfVvev6DxlvShy5w5Mpai-i6Vk6Qfg",87,3.2,5943,4196,1747,"Nam ultrices, libero non mattis pulvinar, nulla pede ullamcorper augue, a suscipit nulla elit ac nulla. Sed vel enim sit amet nunc viverra dapibus. Nulla suscipit ligula in lacus.",74,2435,29,5.7,7256,6427,829
104,"All These Women (För att inte tala om alla dessa kvinnor)",2007,"https://www.youtube.com/embed/1ywA8TtwJ50","https://encrypted-tbn0.gstatic.com/images?q=tbn:ANd9GcRxLYJSuzc9AAuuJ3R1HulbKM_T8_whdwPZQj7VyYonHOME6fYq",66,8.4,2779,2617,162,"Vestibulum quam sapien, varius ut, blandit non, interdum in, ante. Vestibulum ante ipsum primis in faucibus orci luctus et ultrices posuere cubilia Curae; Duis faucibus accumsan odio. Curabitur convallis.",76,3441,33,9.1,5498,627,4871
105,"The Browning Version",1992,"https://www.youtube.com/embed/vuzplFd3YVY","https://encrypted-tbn0.gstatic.com/images?q=tbn:ANd9GcRUMZIkgEW4ZtYyXTgo6uGdYksy7dreOkd-zJRc1uGna-GAnU3SDQ",66,4.1,8301,3563,4738,"Proin interdum mauris non ligula pellentesque ultrices. Phasellus id sapien in sapien iaculis congue. Vivamus metus arcu, adipiscing molestie, hendrerit at, vulputate vitae, nisl.",66,510,55,3.4,2883,285,2598
106,"Diary of a Shinjuku Thief (Shinjuku dorobo nikki)",2012,"https://www.youtube.com/embed/Xwzwmc2AZYg","https://encrypted-tbn0.gstatic.com/images?q=tbn:ANd9GcTlHaTq59e08Zugqn9ZX71XQYUOtuUGEQ9Mkl_HR1NmuSBceL7O",22,1,2016,4125,-2109,"Quisque porta volutpat erat. Quisque erat eros, viverra eget, congue eget, semper rutrum, nulla. Nunc purus.",54,4828,42,8.4,3530,2965,565
107,"Alive",2005,"https://www.youtube.com/embed/wKvOud9GcRQ","https://encrypted-tbn0.gstatic.com/images?q=tbn:ANd9GcRauFfIne8mHbF9MCn-LxY8C6gHqalPefcj6s8z0B9JZwEnD5A4",26,8.3,118,225,-107,"Suspendisse potenti. In eleifend quam a odio. In hac habitasse platea dictumst.",26,2476,57,4.4,8226,3074,5152
108,"Clifford",2012,"https://www.youtube.com/embed/fkr_djVWStU","https://i.pinimg.com/736x/37/a0/99/37a099570abb65e478268af396315658--brochure-design-colour-combinations.jpg",26,5.4,2795,562,2233,"Praesent blandit. Nam nulla. Integer pede justo, lacinia eget, tincidunt eget, tempus vel, pede.",64,1379,87,2,7146,4712,2434
109,"Man Is Not a Bird (Covek nije tica)",2011,"https://www.youtube.com/embed/dfUJm6XgD7g","https://encrypted-tbn0.gstatic.com/images?q=tbn:ANd9GcRyMl7AW_r-FXiuqUSSUA5Mww484NZ8QAd_-vEbcfX2bB8j-uCn1g",34,3.8,9496,4020,5476,"Sed sagittis. Nam congue, risus semper porta volutpat, quam pede lobortis ligula, sit amet eleifend pede libero quis orci. Nullam molestie nibh in lectus.",26,6673,34,3.4,6469,3412,3057
110,"Holy Flame of the Martial World (Wu lin sheng huo jin)",1999,"https://www.youtube.com/embed/XtgCqMZofqM","https://encrypted-tbn0.gstatic.com/images?q=tbn:ANd9GcQ3liTMd9u-FOh16V1KslqpsRMQ7s9_8wAeiIkai8222SoHyIRe",77,4.4,4324,573,3751,"Cras non velit nec nisi vulputate nonummy. Maecenas tincidunt lacus at velit. Vivamus vel nulla eget eros elementum pellentesque.",100,1882,22,9.5,2883,3607,-724
111,"7 Women (a.k.a. Seven Women)",1985,"https://www.youtube.com/embed/eAIjuMHKEiA","https://encrypted-tbn0.gstatic.com/images?q=tbn:ANd9GcTppyYABMyqegOc4I6b3NS0iUaX0R6Cy1-PlahMrPPUzzqPNux9Gg",55,4.8,9496,361,9135,"Morbi porttitor lorem id ligula. Suspendisse ornare consequat lectus. In est risus, auctor sed, tristique in, tempus sit amet, sem.",52,281,56,6.8,9389,898,8491
112,"Payday",2005,"https://www.youtube.com/embed/-6jCNhebfg8","https://encrypted-tbn0.gstatic.com/images?q=tbn:ANd9GcQj3o8UxHr9-tOcX5N5ppAE1Y9EZS5-9IYjKEogAzmsetJB5g0w",4,1.1,8816,1560,7256,"Donec diam neque, vestibulum eget, vulputate ut, ultrices vel, augue. Vestibulum ante ipsum primis in faucibus orci luctus et ultrices posuere cubilia Curae; Donec pharetra, magna vestibulum aliquet ultrices, erat tortor sollicitudin mi, sit amet lobortis sapien sapien non mi. Integer ac neque.",68,2840,6,9,5542,879,4663
113,"Zatoichi the Outlaw (Zatôichi rôyaburi) (Zatôichi 16)",2007,"https://www.youtube.com/embed/yuYoFVHkvIA","https://encrypted-tbn0.gstatic.com/images?q=tbn:ANd9GcSfenuQRjGbddBAE4j3I_GN73Ch-EI9uairOfxWWbLQYAluLoDWCQ",61,6,118,4,114,"Quisque id justo sit amet sapien dignissim vestibulum. Vestibulum ante ipsum primis in faucibus orci luctus et ultrices posuere cubilia Curae; Nulla dapibus dolor vel est. Donec odio justo, sollicitudin ut, suscipit a, feugiat et, eros.",70,6777,96,6.8,4108,2443,1665
114,"Babylon 5: In the Beginning",1992,"https://www.youtube.com/embed/-6jCNhebfg8","https://encrypted-tbn0.gstatic.com/images?q=tbn:ANd9GcSsoy4iP--KOCJ5pPhAcbfrQSvWLPYPI3I557hNf2Vfb6OrfrOczg",19,3.1,1555,4124,-2569,"Nulla ut erat id mauris vulputate elementum. Nullam varius. Nulla facilisi.",32,7592,33,8.3,6469,3251,3218
115,"The Living Magoroku",2011,"https://www.youtube.com/embed/uaTAhjdaEuY","https://encrypted-tbn0.gstatic.com/images?q=tbn:ANd9GcQj3o8UxHr9-tOcX5N5ppAE1Y9EZS5-9IYjKEogAzmsetJB5g0w",62,9.5,7146,1374,5772,"Nam ultrices, libero non mattis pulvinar, nulla pede ullamcorper augue, a suscipit nulla elit ac nulla. Sed vel enim sit amet nunc viverra dapibus. Nulla suscipit ligula in lacus.",48,5002,70,2.1,2795,215,2580
116,"Protector (Protektor)",1992,"https://www.youtube.com/embed/fkr_djVWStU","https://encrypted-tbn0.gstatic.com/images?q=tbn:ANd9GcSxYkdQhkFdrUcKH8fJB2yXGC_mRCGuYTVOQUJTDJY0t9GQ7I2_",56,1.8,9496,4712,4784,"Nulla ut erat id mauris vulputate elementum. Nullam varius. Nulla facilisi.",38,4869,13,6.7,2323,1025,1298
117,"Transylvania",2004,"https://www.youtube.com/embed/i6ilL5z6cjA","https://i.pinimg.com/236x/5f/f6/69/5ff6693c3694f55e8ed9738084c4c6b1--d-design-design-concepts.jpg",22,6.7,692,2777,-2085,"Donec diam neque, vestibulum eget, vulputate ut, ultrices vel, augue. Vestibulum ante ipsum primis in faucibus orci luctus et ultrices posuere cubilia Curae; Donec pharetra, magna vestibulum aliquet ultrices, erat tortor sollicitudin mi, sit amet lobortis sapien sapien non mi. Integer ac neque.",40,9805,94,1.5,6774,2999,3775
118,"King Kong",1992,"https://www.youtube.com/embed/3svtRyLq3b0","https://encrypted-tbn0.gstatic.com/images?q=tbn:ANd9GcRyMl7AW_r-FXiuqUSSUA5Mww484NZ8QAd_-vEbcfX2bB8j-uCn1g",56,2.1,8301,3607,4694,"Nulla ut erat id mauris vulputate elementum. Nullam varius. Nulla facilisi.",22,694,98,9.6,3530,3607,-77
119,"Murder Ahoy",2006,"https://www.youtube.com/embed/dfUJm6XgD7g","https://i.pinimg.com/736x/37/a0/99/37a099570abb65e478268af396315658--brochure-design-colour-combinations.jpg",48,6,6774,9584,-2810,"Aliquam quis turpis eget elit sodales scelerisque. Mauris sit amet eros. Suspendisse accumsan tortor quis turpis.",28,7121,38,8.9,2269,156,2113
120,"Alive",1997,"https://www.youtube.com/embed/sZ8e_0i7UDk","https://encrypted-tbn0.gstatic.com/images?q=tbn:ANd9GcQ6bssTSRlLtGI7nwGNoiKWx9hXXrZsIq1bCgawmuzsVpmbrHCZ3g",60,3.4,4324,3527,797,"Morbi non lectus. Aliquam sit amet diam in magna bibendum imperdiet. Nullam orci pede, venenatis non, sodales sed, tincidunt eu, felis.",26,1948,9,4.8,6072,4020,2052
121,"The Big Trail",2010,"https://www.youtube.com/embed/fnLjm_yL7vE","https://encrypted-tbn0.gstatic.com/images?q=tbn:ANd9GcRWaaeSy6yTdILVOdHiDa9DWFAM4DhQ1JlJvUBR4vWbVoeZznD-",31,2.4,1555,263,1292,"In sagittis dui vel nisl. Duis ac nibh. Fusce lacus purus, aliquet at, feugiat non, pretium quis, lectus.",38,7690,95,7.8,8496,6554,1942
122,"King Kong",1997,"https://www.youtube.com/embed/SF0w2B6DNUE","https://encrypted-tbn0.gstatic.com/images?q=tbn:ANd9GcQT7MRD7KMXMfYFZ3Qi33LI-_bu1Q0DxOyhQgqolg06W2PrTbVuWg",70,1.8,3923,2711,1212,"Nam ultrices, libero non mattis pulvinar, nulla pede ullamcorper augue, a suscipit nulla elit ac nulla. Sed vel enim sit amet nunc viverra dapibus. Nulla suscipit ligula in lacus.",80,4185,20,6.3,8715,3371,5344
123,"Second Wind (Le deuxième souffle) (Second Breath)",1977,"https://www.youtube.com/embed/ee12SvnnrSw","https://encrypted-tbn0.gstatic.com/images?q=tbn:ANd9GcSfenuQRjGbddBAE4j3I_GN73Ch-EI9uairOfxWWbLQYAluLoDWCQ",23,5.9,5146,305,4841,"Donec diam neque, vestibulum eget, vulputate ut, ultrices vel, augue. Vestibulum ante ipsum primis in faucibus orci luctus et ultrices posuere cubilia Curae; Donec pharetra, magna vestibulum aliquet ultrices, erat tortor sollicitudin mi, sit amet lobortis sapien sapien non mi. Integer ac neque.",50,694,24,8.3,7683,4,7679
124,"Gunday",1997,"https://www.youtube.com/embed/YVYzxm_RqMg","https://encrypted-tbn0.gstatic.com/images?q=tbn:ANd9GcQ_K_OlRU89USb4Vi53WsTFwqiEXKhfRUVw08lWTiH5XSmSISDDwg",49,8.4,8496,1575,6921,"Donec diam neque, vestibulum eget, vulputate ut, ultrices vel, augue. Vestibulum ante ipsum primis in faucibus orci luctus et ultrices posuere cubilia Curae; Donec pharetra, magna vestibulum aliquet ultrices, erat tortor sollicitudin mi, sit amet lobortis sapien sapien non mi. Integer ac neque.",52,2789,23,4.6,7383,1741,5642
125,"Elvis Meets Nixon",2006,"https://www.youtube.com/embed/hgBj5b1TTDQ","https://encrypted-tbn0.gstatic.com/images?q=tbn:ANd9GcTXDcq3lfWD_dPTVpQSNf6H8Sg12ilkGrxNouqLt7Nra0lQvOOO",6,8.5,6386,218,6168,"Proin eu mi. Nulla ac enim. In tempor, turpis nec euismod scelerisque, quam turpis adipiscing lorem, vitae mattis nibh ligula nec sem.",98,4907,20,2.1,9090,1504,7586
126,"The Browning Version",1994,"https://www.youtube.com/embed/7Yz10uCVNVk","https://encrypted-tbn0.gstatic.com/images?q=tbn:ANd9GcQtbFBdNfjGVCo1GPJC_9PUkUc7wRIwwh0PMwS76SEP_QTtAyat",40,6,3624,1898,1726,"Praesent blandit. Nam nulla. Integer pede justo, lacinia eget, tincidunt eget, tempus vel, pede.",30,5410,95,4.2,1360,3074,-1714
127,"The Wrong Move",2003,"https://www.youtube.com/embed/fPq4zW9QZSg","https://encrypted-tbn0.gstatic.com/images?q=tbn:ANd9GcQ1aky5NsvfU2oObNVwH5j9ZHJNNcxRkRhHEYTh8yhtqNLPmxk0lA",22,7.8,284,3428,-3144,"Proin leo odio, porttitor id, consequat in, consequat ut, nulla. Sed accumsan felis. Ut at dolor quis odio consequat varius.",88,4252,28,3.2,7683,4860,2823
128,"The Wrong Move",2005,"https://www.youtube.com/embed/iM8kaNCrnX0","https://encrypted-tbn0.gstatic.com/images?q=tbn:ANd9GcSYy4S-T_nbr708KkpYcV-RgmyX_MPtCXzFVr44X7S9CAQsyQAE3Q",30,5.9,3923,3428,495,"Nulla ut erat id mauris vulputate elementum. Nullam varius. Nulla facilisi.",86,3455,69,1.2,2733,7659,-4926
129,"Operation 'Y' & Other Shurik's Adventures",2000,"https://www.youtube.com/embed/DIOW-kR_ams","https://encrypted-tbn0.gstatic.com/images?q=tbn:ANd9GcSQ-QvEfMwKoUuWLDF2x2M1V4BTEN6-uoYrr8ShYvdSVQcHru6h",48,3.2,753,156,597,"Praesent blandit. Nam nulla. Integer pede justo, lacinia eget, tincidunt eget, tempus vel, pede.",30,7592,2,8.4,1555,1983,-428
130,"Digging Up the Marrow",1998,"https://www.youtube.com/embed/_c3WIprIGHE","https://encrypted-tbn0.gstatic.com/images?q=tbn:ANd9GcTppyYABMyqegOc4I6b3NS0iUaX0R6Cy1-PlahMrPPUzzqPNux9Gg",38,2.4,6774,215,6559,"Proin interdum mauris non ligula pellentesque ultrices. Phasellus id sapien in sapien iaculis congue. Vivamus metus arcu, adipiscing molestie, hendrerit at, vulputate vitae, nisl.",42,9683,66,1.5,2777,2711,66
131,"Dorado, El",2007,"https://www.youtube.com/embed/1ywA8TtwJ50","https://encrypted-tbn0.gstatic.com/images?q=tbn:ANd9GcSaZZLwGXqiNU5rkhexU86wKZGzymZWTp2nKRDFdITh7rD7Jb6yGA",80,4.8,8437,2198,6239,"Donec diam neque, vestibulum eget, vulputate ut, ultrices vel, augue. Vestibulum ante ipsum primis in faucibus orci luctus et ultrices posuere cubilia Curae; Donec pharetra, magna vestibulum aliquet ultrices, erat tortor sollicitudin mi, sit amet lobortis sapien sapien non mi. Integer ac neque.",30,962,20,4.1,8382,3444,4938
132,"Hype!",1999,"https://www.youtube.com/embed/cYAtvv-wopk","https://encrypted-tbn0.gstatic.com/images?q=tbn:ANd9GcQ6bssTSRlLtGI7nwGNoiKWx9hXXrZsIq1bCgawmuzsVpmbrHCZ3g",82,3.4,4286,8629,-4343,"Praesent blandit. Nam nulla. Integer pede justo, lacinia eget, tincidunt eget, tempus vel, pede.",88,510,29,3.1,692,923,-231
133,"The Living Magoroku",2004,"https://www.youtube.com/embed/7C2Nad0aMPg","https://encrypted-tbn0.gstatic.com/images?q=tbn:ANd9GcSflOt4SdSx3LCTNP7im_XpsqHeeK_V_ltLPZEnK4mLjl4Eja_t",94,7.5,8715,2308,6407,"Quisque porta volutpat erat. Quisque erat eros, viverra eget, congue eget, semper rutrum, nulla. Nunc purus.",26,1317,75,2.8,5160,1504,3656
134,"Digging Up the Marrow",2010,"https://www.youtube.com/embed/jEnIfGQ_UuQ","https://encrypted-tbn0.gstatic.com/images?q=tbn:ANd9GcSxYkdQhkFdrUcKH8fJB2yXGC_mRCGuYTVOQUJTDJY0t9GQ7I2_",11,3.8,8301,1983,6318,"Cras mi pede, malesuada in, imperdiet et, commodo vulputate, justo. In blandit ultrices enim. Lorem ipsum dolor sit amet, consectetuer adipiscing elit.",28,4907,62,1.4,8388,2617,5771
135,"Block-Heads",2001,"https://www.youtube.com/embed/fPq4zW9QZSg","https://encrypted-tbn0.gstatic.com/images?q=tbn:ANd9GcRJqLpbXoWWpbGuNXVAuF8Iy2X8EFCKx-z2jPdj5XGEL_wrFgzY",77,1.2,8454,7462,992,"Donec diam neque, vestibulum eget, vulputate ut, ultrices vel, augue. Vestibulum ante ipsum primis in faucibus orci luctus et ultrices posuere cubilia Curae; Donec pharetra, magna vestibulum aliquet ultrices, erat tortor sollicitudin mi, sit amet lobortis sapien sapien non mi. Integer ac neque.",64,5258,34,2.8,5704,1037,4667
136,"The Story of Xinghua",1997,"https://www.youtube.com/embed/dfUJm6XgD7g","https://encrypted-tbn0.gstatic.com/images?q=tbn:ANd9GcT8fsnqcp8Y3Y2dxkM4H8TJyS7bRYttijiNFZ-mruoqpzO29uM7",38,2.1,8437,5515,2922,"Proin eu mi. Nulla ac enim. In tempor, turpis nec euismod scelerisque, quam turpis adipiscing lorem, vitae mattis nibh ligula nec sem.",28,1882,26,2.8,198,2606,-2408
137,"Miami Vice",1985,"https://www.youtube.com/embed/fPq4zW9QZSg","https://encrypted-tbn0.gstatic.com/images?q=tbn:ANd9GcQX7g7WDTuGnT2syPcShrXK1gFJn4uMaACeAnWvesheIZXX58K1",77,7.8,6199,879,5320,"In congue. Etiam justo. Etiam pretium iaculis justo.",62,3776,81,6.7,1360,2352,-992
138,"Wing and a Prayer",2000,"https://www.youtube.com/embed/hgBj5b1TTDQ","https://encrypted-tbn0.gstatic.com/images?q=tbn:ANd9GcQaa7JH1TX7xtU8SpR35IjPOWF7HSujPYnfqJy-FlHEfxv6HXq3tQ",89,3.8,8816,6427,2389,"In hac habitasse platea dictumst. Etiam faucibus cursus urna. Ut tellus.",22,3455,70,3.2,2777,9584,-6807
139,"Quand je serai petit",1997,"https://www.youtube.com/embed/MExr5cmGsC4","https://images-na.ssl-images-amazon.com/images/I/41SFojuU1FL._SY600_.jpg",83,1.8,5542,218,5324,"In congue. Etiam justo. Etiam pretium iaculis justo.",56,25,11,4.4,9389,3251,6138
140,"Barabbas",1985,"https://www.youtube.com/embed/sZ8e_0i7UDk","https://encrypted-tbn0.gstatic.com/images?q=tbn:ANd9GcQtbFBdNfjGVCo1GPJC_9PUkUc7wRIwwh0PMwS76SEP_QTtAyat",38,4.8,9416,3313,6103,"Phasellus sit amet erat. Nulla tempus. Vivamus in felis eu sapien cursus vestibulum.",82,6113,29,4.7,6072,1590,4482
141,"The Indian Runner",2010,"https://www.youtube.com/embed/DyQ8PoBV_Vo","https://encrypted-tbn0.gstatic.com/images?q=tbn:ANd9GcSabPrm9QL3aakFmkc9kWlHSQ9uzP10Yf493F57vDv3FicybY8YIg",59,4.6,8454,3074,5380,"Praesent id massa id nisl venenatis lacinia. Aenean sit amet justo. Morbi ut odio.",58,962,7,8.3,3624,2596,1028
142,"The Poseidon Adventure",2011,"https://www.youtube.com/embed/DIOW-kR_ams","https://encrypted-tbn0.gstatic.com/images?q=tbn:ANd9GcT11kibbY7ZQKvhvKatIRRKfv-n-n77Ve-QuVdMOoMg-fol_k9j",38,1.5,2269,6427,-4158,"Proin leo odio, porttitor id, consequat in, consequat ut, nulla. Sed accumsan felis. Ut at dolor quis odio consequat varius.",50,6139,4,3.1,5696,73,5623
143,"Murder Ahoy",2006,"https://www.youtube.com/embed/sZ8e_0i7UDk","https://encrypted-tbn0.gstatic.com/images?q=tbn:ANd9GcT11kibbY7ZQKvhvKatIRRKfv-n-n77Ve-QuVdMOoMg-fol_k9j",4,1,3801,3527,274,"In quis justo. Maecenas rhoncus aliquam lacus. Morbi quis tortor id nulla ultrices aliquet.",68,8546,9,4.4,5696,3251,2445
144,"Payday",2003,"https://www.youtube.com/embed/sZ8e_0i7UDk","https://encrypted-tbn0.gstatic.com/images?q=tbn:ANd9GcRyMl7AW_r-FXiuqUSSUA5Mww484NZ8QAd_-vEbcfX2bB8j-uCn1g",6,7.8,6869,5284,1585,"Duis aliquam convallis nunc. Proin at turpis a pede posuere nonummy. Integer non velit.",64,6770,24,5.7,6199,1545,4654
145,"King Kong",2007,"https://www.youtube.com/embed/PdL8kn_G5EQ","https://encrypted-tbn0.gstatic.com/images?q=tbn:ANd9GcQ1NxrNXukXKIzYZ8UbVazSnR-5741v5UDQPpMMVUvn_2I28fMZ",11,3.2,8301,3648,4653,"Praesent blandit. Nam nulla. Integer pede justo, lacinia eget, tincidunt eget, tempus vel, pede.",28,2789,81,3.2,7900,1560,6340
146,"Coming Down the Mountain",1992,"https://www.youtube.com/embed/PdL8kn_G5EQ","https://encrypted-tbn0.gstatic.com/images?q=tbn:ANd9GcS_NoH0Aw_5YFsBFwfBPn_O7YPHXumI5V3iQ2s7B-3zPU_7sSm1gA",80,2.4,3923,2606,1317,"Cum sociis natoque penatibus et magnis dis parturient montes, nascetur ridiculus mus. Vivamus vestibulum sagittis sapien. Cum sociis natoque penatibus et magnis dis parturient montes, nascetur ridiculus mus.",70,5941,24,9.6,132,573,-441
147,"Fair Game",2012,"https://www.youtube.com/embed/YVYzxm_RqMg","https://encrypted-tbn0.gstatic.com/images?q=tbn:ANd9GcToWUNrpDN1sKiQrTBrAPVZaaHkjYWkdwsMh5Igburh2w20IPRs",10,6.2,698,831,-133,"Suspendisse potenti. In eleifend quam a odio. In hac habitasse platea dictumst.",88,2629,13,2.9,2779,562,2217
148,"Dr. Jekyll and Ms. Hyde",2010,"https://www.youtube.com/embed/eqDHqOcXjRQ","https://encrypted-tbn0.gstatic.com/images?q=tbn:ANd9GcQ06LkOABmCBkCQO4wr6V0tHNUOyUYNR-YLaEHAblZo1ZqlooBmOg",37,1.2,9696,176,9520,"Integer ac leo. Pellentesque ultrices mattis odio. Donec vitae nisi.",56,9178,56,2,7576,2001,5575
149,"Quand je serai petit",2011,"https://www.youtube.com/embed/MpJEOpsVWtA","https://encrypted-tbn0.gstatic.com/images?q=tbn:ANd9GcTTLFfQrJmhvXjL4d_udm6Z89QYglVi4hTEmbaDRdDoqHQsaQVg",82,1.1,2733,3313,-580,"Morbi non lectus. Aliquam sit amet diam in magna bibendum imperdiet. Nullam orci pede, venenatis non, sodales sed, tincidunt eu, felis.",96,9805,19,2,7383,3313,4070
150,"Blow Out",1977,"https://www.youtube.com/embed/nmGmu-knybU","https://encrypted-tbn0.gstatic.com/images?q=tbn:ANd9GcRboE_Oz4pmq_fbkSzc09GrZ6-FxQU9Zh64Y6b3LNLomLOlE4VEzQ",43,2.4,5498,156,5342,"Vestibulum quam sapien, varius ut, blandit non, interdum in, ante. Vestibulum ante ipsum primis in faucibus orci luctus et ultrices posuere cubilia Curae; Duis faucibus accumsan odio. Curabitur convallis.",26,6632,4,8.1,6774,3563,3211
151,"AVPR: Aliens vs. Predator - Requiem",1992,"https://www.youtube.com/embed/RyYFAqJFYdE","https://encrypted-tbn0.gstatic.com/images?q=tbn:ANd9GcTVx6QbLHPUKkVSj1TkaOANhnRfjtIXHhKnHSaIR2y3RkCgry-X",35,3.9,132,361,-229,"Cras non velit nec nisi vulputate nonummy. Maecenas tincidunt lacus at velit. Vivamus vel nulla eget eros elementum pellentesque.",22,4897,55,6.9,8816,7462,1354
152,"Protector (Protektor)",1994,"https://www.youtube.com/embed/fPq4zW9QZSg","https://encrypted-tbn0.gstatic.com/images?q=tbn:ANd9GcSRkE8RSex-89LA2Msfb1Vq6eH047lvDYppmp9IwK2zLgw2nbE-Uw",64,1.8,3411,7219,-3808,"Aliquam quis turpis eget elit sodales scelerisque. Mauris sit amet eros. Suspendisse accumsan tortor quis turpis.",36,6868,66,5.7,3019,1037,1982
153,"Elvis Meets Nixon",2009,"https://www.youtube.com/embed/vuzplFd3YVY","https://encrypted-tbn0.gstatic.com/images?q=tbn:ANd9GcSkjHflFbGJwA3Dk6FW71ynZ5C6z_y9dkcX7Q0Q-2NSkRIUerlH",26,8.3,9822,2999,6823,"In sagittis dui vel nisl. Duis ac nibh. Fusce lacus purus, aliquet at, feugiat non, pretium quis, lectus.",72,607,56,1.1,8377,5471,2906
154,"Meet the Fockers",2011,"https://www.youtube.com/embed/MNp1LPm3Krs","https://encrypted-tbn0.gstatic.com/images?q=tbn:ANd9GcSsoy4iP--KOCJ5pPhAcbfrQSvWLPYPI3I557hNf2Vfb6OrfrOczg",57,4.2,2409,3648,-1239,"Duis bibendum. Morbi non quam nec dui luctus rutrum. Nulla tellus.",50,1528,70,7,8715,156,8559
155,"Overnight Delivery",2002,"https://www.youtube.com/embed/kWuwuQ0X9OA","http://pictify.saatchigallery.com/files/works/chagall-vitraux-pour-jerusalem-poster-chagall-la-tribu-de-1363528645.jpg",31,4.8,4108,3648,460,"Nulla ut erat id mauris vulputate elementum. Nullam varius. Nulla facilisi.",44,8851,96,1.8,2883,2711,172
156,"The Story of Xinghua",1998,"https://www.youtube.com/embed/iOMxsy8S7hk","https://encrypted-tbn0.gstatic.com/images?q=tbn:ANd9GcSAeZgM34QBLW9W6aAQ7xBcJIa1KwtfVVcFHkKpsxvOjDBmNvh0",56,1,2847,3074,-227,"Quisque id justo sit amet sapien dignissim vestibulum. Vestibulum ante ipsum primis in faucibus orci luctus et ultrices posuere cubilia Curae; Nulla dapibus dolor vel est. Donec odio justo, sollicitudin ut, suscipit a, feugiat et, eros.",84,4526,50,8.3,1555,5284,-3729
157,"Poolboy: Drowning Out the Fury",1965,"https://www.youtube.com/embed/I7YdOosOjTU","https://encrypted-tbn0.gstatic.com/images?q=tbn:ANd9GcTt-58zOD-K4oKQ0AbvYduMdi-NxFRYLjx9Maf9ECQJMZkvfanqUw",62,6.3,5541,8964,-3423,"Sed sagittis. Nam congue, risus semper porta volutpat, quam pede lobortis ligula, sit amet eleifend pede libero quis orci. Nullam molestie nibh in lectus.",96,2629,66,5.1,4324,3313,1011
158,"Zatoichi the Outlaw (Zatôichi rôyaburi) (Zatôichi 16)",2012,"https://www.youtube.com/embed/8W6yYBAUxv4","https://encrypted-tbn0.gstatic.com/images?q=tbn:ANd9GcQvLz9_jwOs-MucEN-bWUhjq9aaYyfVvyNoFoGgGFdFJBMuXq1yqw",66,4.8,9899,73,9826,"Integer ac leo. Pellentesque ultrices mattis odio. Donec vitae nisi.",32,3776,50,3.2,7900,73,7827
159,"The Land Before Time XII: The Great Day of the Flyers",1995,"https://www.youtube.com/embed/RaA9elSYnpQ","https://encrypted-tbn0.gstatic.com/images?q=tbn:ANd9GcRUlnvuLTJg0mT65nGxwZY6OfVvev6DxlvShy5w5Mpai-i6Vk6Qfg",98,8.4,7256,215,7041,"Quisque id justo sit amet sapien dignissim vestibulum. Vestibulum ante ipsum primis in faucibus orci luctus et ultrices posuere cubilia Curae; Nulla dapibus dolor vel est. Donec odio justo, sollicitudin ut, suscipit a, feugiat et, eros.",70,458,61,9.6,2016,1575,441
160,"Edmond",2005,"https://www.youtube.com/embed/ocWpGdITSR4","https://encrypted-tbn0.gstatic.com/images?q=tbn:ANd9GcSfdl_pNap7w4wYTP7dhiozrcmHAmCcADuvkKlsj19tBpxYkq60LA",65,4.1,5146,627,4519,"Mauris enim leo, rhoncus sed, vestibulum sit amet, cursus id, turpis. Integer aliquet, massa id lobortis convallis, tortor risus dapibus augue, vel accumsan tellus nisi eu orci. Mauris lacinia sapien quis libero.",62,5002,77,1.1,4108,305,3803
161,"Bird of Paradise",1986,"https://www.youtube.com/embed/3svtRyLq3b0","https://encrypted-tbn0.gstatic.com/images?q=tbn:ANd9GcTt-58zOD-K4oKQ0AbvYduMdi-NxFRYLjx9Maf9ECQJMZkvfanqUw",6,7.7,7715,6366,1349,"Cum sociis natoque penatibus et magnis dis parturient montes, nascetur ridiculus mus. Vivamus vestibulum sagittis sapien. Cum sociis natoque penatibus et magnis dis parturient montes, nascetur ridiculus mus.",42,1620,69,2.4,1360,3771,-2411
162,"The Tic Code",1999,"https://www.youtube.com/embed/cENucEoMZic","https://encrypted-tbn0.gstatic.com/images?q=tbn:ANd9GcRUMZIkgEW4ZtYyXTgo6uGdYksy7dreOkd-zJRc1uGna-GAnU3SDQ",26,9.3,3624,7659,-4035,"Cras non velit nec nisi vulputate nonummy. Maecenas tincidunt lacus at velit. Vivamus vel nulla eget eros elementum pellentesque.",30,9885,42,9.6,2777,2711,66
163,"Rabid Grannies (Mémés cannibales, Les)",2011,"https://www.youtube.com/embed/MNp1LPm3Krs","https://encrypted-tbn0.gstatic.com/images?q=tbn:ANd9GcQvLz9_jwOs-MucEN-bWUhjq9aaYyfVvyNoFoGgGFdFJBMuXq1yqw",70,2.4,2883,1214,1669,"Praesent blandit. Nam nulla. Integer pede justo, lacinia eget, tincidunt eget, tempus vel, pede.",28,3074,20,8.4,5160,2443,2717
164,"Breaking the Silence: Truth and Lies in the War on Terror",1997,"https://www.youtube.com/embed/iOMxsy8S7hk","https://encrypted-tbn0.gstatic.com/images?q=tbn:ANd9GcSZ6r6rDjMvQsp22jqT0ZPe_z-oKhAWQcjwgB5egzck4lqzLHYHCg",6,6.9,6869,2489,4380,"Quisque porta volutpat erat. Quisque erat eros, viverra eget, congue eget, semper rutrum, nulla. Nunc purus.",62,6719,70,7.7,2795,4020,-1225
165,"Level Five",1996,"https://www.youtube.com/embed/fnLjm_yL7vE","https://encrypted-tbn0.gstatic.com/images?q=tbn:ANd9GcQvfJ-vLQ5TK13ND8sY6H-r6cm_4f3SnW_WAWn2vuX-nGh6F8JquQ",17,9.6,8715,2999,5716,"Phasellus sit amet erat. Nulla tempus. Vivamus in felis eu sapien cursus vestibulum.",40,7146,2,1.8,2034,6554,-4520
166,"Murder Ahoy",2012,"https://www.youtube.com/embed/VUEaDUyeTR8","https://images-na.ssl-images-amazon.com/images/I/41SFojuU1FL._SY600_.jpg",37,9.1,3417,3527,-110,"Curabitur in libero ut massa volutpat convallis. Morbi odio odio, elementum eu, interdum eu, tincidunt in, leo. Maecenas pulvinar lobortis est.",88,3776,11,8.1,8816,3539,5277
167,"Meet the Fockers",1999,"https://www.youtube.com/embed/3_bUymlkSuA","https://encrypted-tbn0.gstatic.com/images?q=tbn:ANd9GcTjDxlkO4SurlCq11A009Vm2yOW0XT4x5GHflg-pkVrTiqWURnydg",82,2.4,7383,3607,3776,"Cras non velit nec nisi vulputate nonummy. Maecenas tincidunt lacus at velit. Vivamus vel nulla eget eros elementum pellentesque.",98,5410,4,3.4,7393,7462,-69
168,"Dragon Ball Z the Movie: The World's Strongest (a.k.a. Dragon Ball Z: The Strongest Guy in The World) (Doragon bôru Z: Kono yo de ichiban tsuyoi yatsu)",2011,"https://www.youtube.com/embed/PdL8kn_G5EQ","https://encrypted-tbn0.gstatic.com/images?q=tbn:ANd9GcSfdl_pNap7w4wYTP7dhiozrcmHAmCcADuvkKlsj19tBpxYkq60LA",50,5.1,4108,831,3277,"Cum sociis natoque penatibus et magnis dis parturient montes, nascetur ridiculus mus. Vivamus vestibulum sagittis sapien. Cum sociis natoque penatibus et magnis dis parturient montes, nascetur ridiculus mus.",48,9441,55,9.6,132,1545,-1413
169,"The Wrong Move",1997,"https://www.youtube.com/embed/iaM3y7uDL90","https://encrypted-tbn0.gstatic.com/images?q=tbn:ANd9GcSr9sVCqvsx-91eeqQvyCjpe4Fo7sap42UGJTn3IzdyIQVFy39R",57,2.4,2016,6885,-4869,"Curabitur in libero ut massa volutpat convallis. Morbi odio odio, elementum eu, interdum eu, tincidunt in, leo. Maecenas pulvinar lobortis est.",86,2840,26,5.4,7576,6494,1082
170,"The Pit, the Pendulum and Hope",2009,"https://www.youtube.com/embed/KbZ3TVEkuDY","https://encrypted-tbn0.gstatic.com/images?q=tbn:ANd9GcTiS27rf1ltLwxOAbTBhYvqJuvJG8ctIALtoknQh7MHlvV3r0UO",70,1.4,2779,781,1998,"Duis bibendum. Morbi non quam nec dui luctus rutrum. Nulla tellus.",40,7592,23,6.2,6469,898,5571
171,"American Pie Presents The Naked Mile (American Pie 5: The Naked Mile)",2012,"https://www.youtube.com/embed/1roy4o4tqQM","http://pictify.saatchigallery.com/files/works/chagall-vitraux-pour-jerusalem-poster-chagall-la-tribu-de-1363528645.jpg",57,2.4,2795,2240,555,"Morbi non lectus. Aliquam sit amet diam in magna bibendum imperdiet. Nullam orci pede, venenatis non, sodales sed, tincidunt eu, felis.",44,4185,98,6,2733,2489,244
172,"Dragon Ball Z the Movie: The World's Strongest (a.k.a. Dragon Ball Z: The Strongest Guy in The World) (Doragon bôru Z: Kono yo de ichiban tsuyoi yatsu)",2011,"https://www.youtube.com/embed/LcepHRTWI18","https://encrypted-tbn0.gstatic.com/images?q=tbn:ANd9GcQX7g7WDTuGnT2syPcShrXK1gFJn4uMaACeAnWvesheIZXX58K1",75,9.6,698,831,-133,"Morbi non lectus. Aliquam sit amet diam in magna bibendum imperdiet. Nullam orci pede, venenatis non, sodales sed, tincidunt eu, felis.",28,8567,88,3.8,6275,5228,1047
173,"Barabbas",1998,"https://www.youtube.com/embed/SF0w2B6DNUE","https://encrypted-tbn0.gstatic.com/images?q=tbn:ANd9GcT11kibbY7ZQKvhvKatIRRKfv-n-n77Ve-QuVdMOoMg-fol_k9j",96,5.9,118,3607,-3489,"Quisque id justo sit amet sapien dignissim vestibulum. Vestibulum ante ipsum primis in faucibus orci luctus et ultrices posuere cubilia Curae; Nulla dapibus dolor vel est. Donec odio justo, sollicitudin ut, suscipit a, feugiat et, eros.",96,6770,69,2.4,3605,5515,-1910
174,"Joe Kidd",2011,"https://www.youtube.com/embed/6W0KFTj50zI","https://encrypted-tbn0.gstatic.com/images?q=tbn:ANd9GcQ5LAO-oqK_jHF33R_asKWptHCRYc_456jcsgrngpU6q8htwl24",24,2.9,284,831,-547,"Sed ante. Vivamus tortor. Duis mattis egestas metus.",74,1631,28,1,7762,923,6839
175,"The Stars Fell on Henrietta",1989,"https://www.youtube.com/embed/THq6KlWgiqw","https://encrypted-tbn0.gstatic.com/images?q=tbn:ANd9GcT5qYZ7WL1XpLSuZms35fvGdxwAwN8ZoDje7zRyyFHfFSsWWAHelQ",36,3.4,6006,2352,3654,"Donec diam neque, vestibulum eget, vulputate ut, ultrices vel, augue. Vestibulum ante ipsum primis in faucibus orci luctus et ultrices posuere cubilia Curae; Donec pharetra, magna vestibulum aliquet ultrices, erat tortor sollicitudin mi, sit amet lobortis sapien sapien non mi. Integer ac neque.",62,7146,26,3.1,5541,8964,-3423
176,"The Story of Xinghua",1997,"https://www.youtube.com/embed/YoBOCxBq88A","https://encrypted-tbn0.gstatic.com/images?q=tbn:ANd9GcSutU5UF40fwtxDcA61fL6VFTPKJYlaJOeUxSuI4qfpFQYO1KZ3",60,6.7,2481,4712,-2231,"Praesent id massa id nisl venenatis lacinia. Aenean sit amet justo. Morbi ut odio.",38,5258,87,7.2,3605,1741,1864
177,"When Time Ran Out...",1997,"https://www.youtube.com/embed/dfUJm6XgD7g","https://encrypted-tbn0.gstatic.com/images?q=tbn:ANd9GcRzG_G5zPWeZkXUBRL8pbpkKLG3hoQE92XKfYAayAo71EQzgXmv",7,1.1,5696,2001,3695,"Fusce consequat. Nulla nisl. Nunc nisl.",56,4185,64,5.1,8410,2489,5921
178,"The Prisoner",1996,"https://www.youtube.com/embed/8oTXc5t35Ro","https://encrypted-tbn0.gstatic.com/images?q=tbn:ANd9GcQX7g7WDTuGnT2syPcShrXK1gFJn4uMaACeAnWvesheIZXX58K1",4,1.7,8388,5471,2917,"Cras non velit nec nisi vulputate nonummy. Maecenas tincidunt lacus at velit. Vivamus vel nulla eget eros elementum pellentesque.",82,2476,31,7,5541,7219,-1678
179,"Talcum Powder",1985,"https://www.youtube.com/embed/VUEaDUyeTR8","https://encrypted-tbn0.gstatic.com/images?q=tbn:ANd9GcQYYT2HR82Tm6jDN6B_0-JbBC3HMcVQoxrwz0iiWHkiPx0sXczovQ",66,2.8,6386,3563,2823,"Integer ac leo. Pellentesque ultrices mattis odio. Donec vitae nisi.",48,2476,55,8.3,7576,2711,4865
180,"When Time Ran Out...",2012,"https://www.youtube.com/embed/6SO96lvWqzc","https://encrypted-tbn0.gstatic.com/images?q=tbn:ANd9GcSabPrm9QL3aakFmkc9kWlHSQ9uzP10Yf493F57vDv3FicybY8YIg",66,1.8,9994,3118,6876,"Integer ac leo. Pellentesque ultrices mattis odio. Donec vitae nisi.",64,5941,26,5.1,3417,3428,-11
181,"Jin Roh: The Wolf Brigade (Jin-Rô)",2007,"https://www.youtube.com/embed/DIOW-kR_ams","https://i.pinimg.com/236x/3b/29/73/3b2973cc00e87a821ad68647747259be--pattern-texture-paints.jpg",55,3.1,6175,1374,4801,"Aliquam quis turpis eget elit sodales scelerisque. Mauris sit amet eros. Suspendisse accumsan tortor quis turpis.",24,9164,83,1.2,2847,2240,607
182,"The Prisoner",2008,"https://www.youtube.com/embed/giIs-AEAX6Y","https://encrypted-tbn0.gstatic.com/images?q=tbn:ANd9GcSYy4S-T_nbr708KkpYcV-RgmyX_MPtCXzFVr44X7S9CAQsyQAE3Q",49,5.7,7146,831,6315,"Proin eu mi. Nulla ac enim. In tempor, turpis nec euismod scelerisque, quam turpis adipiscing lorem, vitae mattis nibh ligula nec sem.",64,8234,34,8.1,5696,537,5159
183,"Thoroughly Modern Millie",1997,"https://www.youtube.com/embed/I7YdOosOjTU","https://encrypted-tbn0.gstatic.com/images?q=tbn:ANd9GcToWUNrpDN1sKiQrTBrAPVZaaHkjYWkdwsMh5Igburh2w20IPRs",29,6.7,7393,1822,5571,"Praesent blandit. Nam nulla. Integer pede justo, lacinia eget, tincidunt eget, tempus vel, pede.",50,8647,62,8.1,3530,4,3526
184,"Tis kakomoiras",2011,"https://www.youtube.com/embed/jEnIfGQ_UuQ","https://encrypted-tbn0.gstatic.com/images?q=tbn:ANd9GcS0uoN_00qCw12_q1GgGAdcbA-6sp6JzFguYZMxLObI8Ydh9OBk",13,8.9,6072,2308,3764,"Sed ante. Vivamus tortor. Duis mattis egestas metus.",62,93,9,3.4,7146,8629,-1483
185,"Babylon 5: In the Beginning",1999,"https://www.youtube.com/embed/I7YdOosOjTU","https://encrypted-tbn0.gstatic.com/images?q=tbn:ANd9GcQN3_I47i-MkaTBmK9e2PzNkhGoJsWeB5U_dn5cat3hDSHLCPjU",34,9.6,5542,1025,4517,"Praesent blandit. Nam nulla. Integer pede justo, lacinia eget, tincidunt eget, tempus vel, pede.",34,2413,56,1.8,118,1496,-1378
186,"Level Five",1985,"https://www.youtube.com/embed/mAX1oGLvMAA","https://encrypted-tbn0.gstatic.com/images?q=tbn:ANd9GcSZ6r6rDjMvQsp22jqT0ZPe_z-oKhAWQcjwgB5egzck4lqzLHYHCg",56,5.1,5146,361,4785,"Lorem ipsum dolor sit amet, consectetuer adipiscing elit. Proin risus. Praesent lectus.",70,1442,66,4.4,2883,2308,575
187,"Condorman",2010,"https://www.youtube.com/embed/uaTAhjdaEuY","https://encrypted-tbn0.gstatic.com/images?q=tbn:ANd9GcQT7MRD7KMXMfYFZ3Qi33LI-_bu1Q0DxOyhQgqolg06W2PrTbVuWg",90,3.2,9496,3313,6183,"Pellentesque at nulla. Suspendisse potenti. Cras in purus eu magna vulputate luctus.",74,4799,77,6.8,6755,2606,4149
188,"The Tic Code",1999,"https://www.youtube.com/embed/Rc3e0m6SpXo","https://encrypted-tbn0.gstatic.com/images?q=tbn:ANd9GcTiS27rf1ltLwxOAbTBhYvqJuvJG8ctIALtoknQh7MHlvV3r0UO",19,1.5,8388,7219,1169,"Mauris enim leo, rhoncus sed, vestibulum sit amet, cursus id, turpis. Integer aliquet, massa id lobortis convallis, tortor risus dapibus augue, vel accumsan tellus nisi eu orci. Mauris lacinia sapien quis libero.",42,6632,66,1,7762,1822,5940
189,"Harry Potter and the Order of the Phoenix",1998,"https://www.youtube.com/embed/_c3WIprIGHE","https://encrypted-tbn0.gstatic.com/images?q=tbn:ANd9GcQoGIgMrMpVA2TiWG8g9ENb7x-ZrciYB-gqzjyCnG-C2EgT8ePfkA",66,3.1,7146,2311,4835,"Suspendisse potenti. In eleifend quam a odio. In hac habitasse platea dictumst.",88,1631,77,1.1,3605,361,3244
190,"The Last Seduction",2009,"https://www.youtube.com/embed/cYAtvv-wopk","https://encrypted-tbn0.gstatic.com/images?q=tbn:ANd9GcRboE_Oz4pmq_fbkSzc09GrZ6-FxQU9Zh64Y6b3LNLomLOlE4VEzQ",34,2,8429,2617,5812,"Curabitur in libero ut massa volutpat convallis. Morbi odio odio, elementum eu, interdum eu, tincidunt in, leo. Maecenas pulvinar lobortis est.",26,7481,33,3.1,9683,879,8804
191,"Condorman",2003,"https://www.youtube.com/embed/7Yz10uCVNVk","https://encrypted-tbn0.gstatic.com/images?q=tbn:ANd9GcQX7g7WDTuGnT2syPcShrXK1gFJn4uMaACeAnWvesheIZXX58K1",9,6.8,6801,1374,5427,"Donec diam neque, vestibulum eget, vulputate ut, ultrices vel, augue. Vestibulum ante ipsum primis in faucibus orci luctus et ultrices posuere cubilia Curae; Donec pharetra, magna vestibulum aliquet ultrices, erat tortor sollicitudin mi, sit amet lobortis sapien sapien non mi. Integer ac neque.",70,1836,31,4.9,692,3444,-2752
192,"Little Nikita",2003,"https://www.youtube.com/embed/i6ilL5z6cjA","https://encrypted-tbn0.gstatic.com/images?q=tbn:ANd9GcSAeZgM34QBLW9W6aAQ7xBcJIa1KwtfVVcFHkKpsxvOjDBmNvh0",26,4.7,2481,4860,-2379,"Vestibulum quam sapien, varius ut, blandit non, interdum in, ante. Vestibulum ante ipsum primis in faucibus orci luctus et ultrices posuere cubilia Curae; Duis faucibus accumsan odio. Curabitur convallis.",30,1948,66,1.8,9683,879,8804
193,"Clifford",2010,"https://www.youtube.com/embed/B12REtkl2KY","https://encrypted-tbn0.gstatic.com/images?q=tbn:ANd9GcRxLYJSuzc9AAuuJ3R1HulbKM_T8_whdwPZQj7VyYonHOME6fYq",62,9.6,2847,4020,-1173,"Proin eu mi. Nulla ac enim. In tempor, turpis nec euismod scelerisque, quam turpis adipiscing lorem, vitae mattis nibh ligula nec sem.",22,2413,9,6.7,6579,3563,3016
194,"Dr. Jekyll and Ms. Hyde",2001,"https://www.youtube.com/embed/EKGATzNnr8c","https://encrypted-tbn0.gstatic.com/images?q=tbn:ANd9GcQvLz9_jwOs-MucEN-bWUhjq9aaYyfVvyNoFoGgGFdFJBMuXq1yqw",61,1.8,4286,263,4023,"Mauris enim leo, rhoncus sed, vestibulum sit amet, cursus id, turpis. Integer aliquet, massa id lobortis convallis, tortor risus dapibus augue, vel accumsan tellus nisi eu orci. Mauris lacinia sapien quis libero.",54,9382,40,1.8,5498,4196,1302
195,"Fido",2003,"https://www.youtube.com/embed/PdL8kn_G5EQ","https://encrypted-tbn0.gstatic.com/images?q=tbn:ANd9GcSZ6r6rDjMvQsp22jqT0ZPe_z-oKhAWQcjwgB5egzck4lqzLHYHCg",33,4.3,5542,5209,333,"Cras non velit nec nisi vulputate nonummy. Maecenas tincidunt lacus at velit. Vivamus vel nulla eget eros elementum pellentesque.",66,2435,49,7,8496,54,8442
196,"Poolboy: Drowning Out the Fury",2012,"https://www.youtube.com/embed/I7YdOosOjTU","https://encrypted-tbn0.gstatic.com/images?q=tbn:ANd9GcTrBuPeRIXbqvHjWMwFg1aZvVkw71rsNVla5A067w7kiY-DPB7N",43,3.4,12,562,-550,"Donec diam neque, vestibulum eget, vulputate ut, ultrices vel, augue. Vestibulum ante ipsum primis in faucibus orci luctus et ultrices posuere cubilia Curae; Donec pharetra, magna vestibulum aliquet ultrices, erat tortor sollicitudin mi, sit amet lobortis sapien sapien non mi. Integer ac neque.",54,1836,66,1.5,7890,8004,-114
197,"Aloft",1992,"https://www.youtube.com/embed/zCecE7OyVMU","https://encrypted-tbn0.gstatic.com/images?q=tbn:ANd9GcSutU5UF40fwtxDcA61fL6VFTPKJYlaJOeUxSuI4qfpFQYO1KZ3",55,1.2,7683,7219,464,"Phasellus in felis. Donec semper sapien a libero. Nam dui.",96,7146,37,3.2,1555,2198,-643
198,"Escaflowne: The Movie (Escaflowne)",2000,"https://www.youtube.com/embed/1roy4o4tqQM","https://encrypted-tbn0.gstatic.com/images?q=tbn:ANd9GcQX7g7WDTuGnT2syPcShrXK1gFJn4uMaACeAnWvesheIZXX58K1",68,6.9,6869,537,6332,"Maecenas leo odio, condimentum id, luctus nec, molestie sed, justo. Pellentesque viverra pede ac diam. Cras pellentesque volutpat dui.",54,9178,25,1.1,8388,7219,1169
199,"Dorado, El",2012,"https://www.youtube.com/embed/ka3J1sUhQ4M","https://encrypted-tbn0.gstatic.com/images?q=tbn:ANd9GcTppyYABMyqegOc4I6b3NS0iUaX0R6Cy1-PlahMrPPUzzqPNux9Gg",64,2.1,7383,3428,3955,"Pellentesque at nulla. Suspendisse potenti. Cras in purus eu magna vulputate luctus.",52,4828,22,7.7,8496,3444,5052
200,"Little Giants",1994,"https://www.youtube.com/embed/B12REtkl2KY","https://encrypted-tbn0.gstatic.com/images?q=tbn:ANd9GcRUMZIkgEW4ZtYyXTgo6uGdYksy7dreOkd-zJRc1uGna-GAnU3SDQ",96,9.5,4602,2596,2006,"Sed ante. Vivamus tortor. Duis mattis egestas metus.",32,1882,48,5.9,2779,1741,1038
201,"Escaflowne: The Movie (Escaflowne)",2011,"https://www.youtube.com/embed/keo8PJecIEc","https://encrypted-tbn0.gstatic.com/images?q=tbn:ANd9GcRmeUcg7O8EkPtcOaGTwx1hvLuj5TbCPLmfq_zT0IhPpcbOWbBUDA",61,3.2,7683,5209,2474,"Praesent id massa id nisl venenatis lacinia. Aenean sit amet justo. Morbi ut odio.",72,4091,61,8.4,7383,1741,5642
202,"Jin Roh: The Wolf Brigade (Jin-Rô)",2002,"https://www.youtube.com/embed/HwWWws3kzKg","https://encrypted-tbn0.gstatic.com/images?q=tbn:ANd9GcSOWY9FWNsfX_XrmFypiMILLGG-QtrQcxL8f5w3qsIiNjiSdC3x",81,1,8816,3771,5045,"Duis aliquam convallis nunc. Proin at turpis a pede posuere nonummy. Integer non velit.",44,6593,78,6.9,7146,5206,1940
203,"Beyond Therapy",2006,"https://www.youtube.com/embed/qqlEGYo0xCA","https://encrypted-tbn0.gstatic.com/images?q=tbn:ANd9GcS_NoH0Aw_5YFsBFwfBPn_O7YPHXumI5V3iQ2s7B-3zPU_7sSm1gA",4,1.1,2779,156,2623,"Fusce consequat. Nulla nisl. Nunc nisl.",22,2413,80,4.1,1191,1575,-384
204,"Gunday",2005,"https://www.youtube.com/embed/iM8kaNCrnX0","https://encrypted-tbn0.gstatic.com/images?q=tbn:ANd9GcSflOt4SdSx3LCTNP7im_XpsqHeeK_V_ltLPZEnK4mLjl4Eja_t",62,1.2,8816,1590,7226,"Sed ante. Vivamus tortor. Duis mattis egestas metus.",88,9683,9,7.2,3605,5284,-1679
205,"Sgt. Bilko",2006,"https://www.youtube.com/embed/4AEkzL2SvmI","https://encrypted-tbn0.gstatic.com/images?q=tbn:ANd9GcSBKrAU7qHXZ_vqij5HmW3xvTgSZ9qA7lT4fxAsUEXHGvWHHXai",42,4.7,9141,4196,4945,"Cum sociis natoque penatibus et magnis dis parturient montes, nascetur ridiculus mus. Vivamus vestibulum sagittis sapien. Cum sociis natoque penatibus et magnis dis parturient montes, nascetur ridiculus mus.",96,1317,34,6,9090,2489,6601
206,"Hardcore",2006,"https://www.youtube.com/embed/tkSuLa3o_5A","https://encrypted-tbn0.gstatic.com/images?q=tbn:ANd9GcRqaaKELSsRKJh2pc05f1s5ksCTCIa-bgxbzGUm2T7leAI2nlTqZw",83,1.1,7715,3607,4108,"Phasellus in felis. Donec semper sapien a libero. Nam dui.",38,1317,96,1.8,753,2489,-1736
207,"The Wrong Move",2011,"https://www.youtube.com/embed/EKGATzNnr8c","https://encrypted-tbn0.gstatic.com/images?q=tbn:ANd9GcSAeZgM34QBLW9W6aAQ7xBcJIa1KwtfVVcFHkKpsxvOjDBmNvh0",62,9.3,3458,2617,841,"Integer ac leo. Pellentesque ultrices mattis odio. Donec vitae nisi.",60,694,62,1.8,9416,6494,2922
208,"Thoroughly Modern Millie",2011,"https://www.youtube.com/embed/RaA9elSYnpQ","https://i.pinimg.com/736x/37/a0/99/37a099570abb65e478268af396315658--brochure-design-colour-combinations.jpg",55,9,9090,5,9085,"Sed sagittis. Nam congue, risus semper porta volutpat, quam pede lobortis ligula, sit amet eleifend pede libero quis orci. Nullam molestie nibh in lectus.",30,2153,26,6.8,4286,9584,-5298
209,"Zatoichi the Outlaw (Zatôichi rôyaburi) (Zatôichi 16)",2006,"https://www.youtube.com/embed/SF0w2B6DNUE","https://encrypted-tbn0.gstatic.com/images?q=tbn:ANd9GcRqaaKELSsRKJh2pc05f1s5ksCTCIa-bgxbzGUm2T7leAI2nlTqZw",36,2.9,1360,54,1306,"Nulla ut erat id mauris vulputate elementum. Nullam varius. Nulla facilisi.",66,3441,49,7.5,2777,2352,425
210,"American Pie Presents The Naked Mile (American Pie 5: The Naked Mile)",2003,"https://www.youtube.com/embed/7C2Nad0aMPg","https://encrypted-tbn0.gstatic.com/images?q=tbn:ANd9GcQ--11hFR6GYIOagDhcOJiqKSIqKz7XB_wRhQklbSwf9d4k8lto",82,2.9,6869,6366,503,"Proin leo odio, porttitor id, consequat in, consequat ut, nulla. Sed accumsan felis. Ut at dolor quis odio consequat varius.",90,2866,66,2.1,2034,772,1262
211,"Tis kakomoiras",1996,"https://www.youtube.com/embed/-6jCNhebfg8","https://encrypted-tbn0.gstatic.com/images?q=tbn:ANd9GcTsjOFvygMO8x-qvjqCJz2LIuSNcJ3SwoL3PgjTz-9CZFQxNyzGng",6,6,5160,8964,-3804,"Vestibulum quam sapien, varius ut, blandit non, interdum in, ante. Vestibulum ante ipsum primis in faucibus orci luctus et ultrices posuere cubilia Curae; Duis faucibus accumsan odio. Curabitur convallis.",28,5002,69,1,7393,225,7168
212,"Level Five",1977,"https://www.youtube.com/embed/Sw_5YPAf7Zs","https://encrypted-tbn0.gstatic.com/images?q=tbn:ANd9GcT3yd_NJLFNa8pH2NX8GufmbmYJmY751UxjTNcB2ALIMGhKfx94gQ",18,5.1,8382,9584,-1202,"Pellentesque at nulla. Suspendisse potenti. Cras in purus eu magna vulputate luctus.",36,607,30,5.1,9416,1504,7912
213,"Quand je serai petit",2007,"https://www.youtube.com/embed/keo8PJecIEc","https://i.pinimg.com/originals/c9/ba/74/c9ba7451301a9003752d2f61b5036730.jpg",55,6.8,8429,1214,7215,"Pellentesque at nulla. Suspendisse potenti. Cras in purus eu magna vulputate luctus.",58,7438,43,3.2,8382,3607,4775
214,"The Tic Code",1992,"https://www.youtube.com/embed/7C2Nad0aMPg","https://encrypted-tbn0.gstatic.com/images?q=tbn:ANd9GcSH9tC-osjnxukCMxARZTOlLqboCFbGakXL0EtWmcFdJO1wQL38",28,6,7146,923,6223,"Fusce consequat. Nulla nisl. Nunc nisl.",58,6770,45,9.5,3624,4125,-501
215,"Babylon 5: In the Beginning",1994,"https://www.youtube.com/embed/fkr_djVWStU","https://encrypted-tbn0.gstatic.com/images?q=tbn:ANd9GcSnUCe3jwoe6TiIdg0tv_j25Q3WHNDjeBfzqlYhOl70hy95_k9t1Q",77,6.9,6275,361,5914,"Nulla ut erat id mauris vulputate elementum. Nullam varius. Nulla facilisi.",80,7702,31,6.9,2883,156,2727
216,"U2: Rattle and Hum",1999,"https://www.youtube.com/embed/dfUJm6XgD7g","https://encrypted-tbn0.gstatic.com/images?q=tbn:ANd9GcT11kibbY7ZQKvhvKatIRRKfv-n-n77Ve-QuVdMOoMg-fol_k9j",36,1.2,2777,4125,-1348,"Proin eu mi. Nulla ac enim. In tempor, turpis nec euismod scelerisque, quam turpis adipiscing lorem, vitae mattis nibh ligula nec sem.",90,1620,59,1,2269,215,2054
217,"Wing and a Prayer",1989,"https://www.youtube.com/embed/eAIjuMHKEiA","http://pictify.saatchigallery.com/files/works/chagall-vitraux-pour-jerusalem-poster-chagall-la-tribu-de-1363528645.jpg",62,2.8,2481,879,1602,"Suspendisse potenti. In eleifend quam a odio. In hac habitasse platea dictumst.",98,6719,77,8.4,7146,7219,-73
218,"Tis kakomoiras",1998,"https://www.youtube.com/embed/h-k0-Z9b4Cw","https://encrypted-tbn0.gstatic.com/images?q=tbn:ANd9GcSsoy4iP--KOCJ5pPhAcbfrQSvWLPYPI3I557hNf2Vfb6OrfrOczg",89,8.1,8377,2606,5771,"Proin eu mi. Nulla ac enim. In tempor, turpis nec euismod scelerisque, quam turpis adipiscing lorem, vitae mattis nibh ligula nec sem.",22,8056,24,9.6,6755,1374,5381
219,"The Last Seduction",2012,"https://www.youtube.com/embed/VccwBGgyzP4","https://i.pinimg.com/236x/3b/29/73/3b2973cc00e87a821ad68647747259be--pattern-texture-paints.jpg",69,3.4,8226,1898,6328,"Cras non velit nec nisi vulputate nonummy. Maecenas tincidunt lacus at velit. Vivamus vel nulla eget eros elementum pellentesque.",26,5002,96,6.8,8715,1983,6732
220,"The Prisoner",2009,"https://www.youtube.com/embed/QJlh0IPQbbo","https://encrypted-tbn0.gstatic.com/images?q=tbn:ANd9GcRUlnvuLTJg0mT65nGxwZY6OfVvev6DxlvShy5w5Mpai-i6Vk6Qfg",4,7.7,2034,831,1203,"Lorem ipsum dolor sit amet, consectetuer adipiscing elit. Proin risus. Praesent lectus.",38,1649,20,4.8,2779,1590,1189
221,"The Tic Code",2012,"https://www.youtube.com/embed/HwWWws3kzKg","https://encrypted-tbn0.gstatic.com/images?q=tbn:ANd9GcQhhglaTqXYejQ2b9TYl15F3E4pAgR1pWjyYyUTJgkHGuKsiWyHrw",26,6.9,9122,4860,4262,"Maecenas leo odio, condimentum id, luctus nec, molestie sed, justo. Pellentesque viverra pede ac diam. Cras pellentesque volutpat dui.",22,3455,98,3.4,8377,2001,6376
222,"Edmond",2012,"https://www.youtube.com/embed/MNp1LPm3Krs","https://encrypted-tbn0.gstatic.com/images?q=tbn:ANd9GcSZ6r6rDjMvQsp22jqT0ZPe_z-oKhAWQcjwgB5egzck4lqzLHYHCg",4,1.8,2016,4124,-2108,"Sed sagittis. Nam congue, risus semper porta volutpat, quam pede lobortis ligula, sit amet eleifend pede libero quis orci. Nullam molestie nibh in lectus.",40,6770,29,8.3,9122,8004,1118
223,"Blow Out",2004,"https://www.youtube.com/embed/oNTzFnMXT3E","https://encrypted-tbn0.gstatic.com/images?q=tbn:ANd9GcSZ6r6rDjMvQsp22jqT0ZPe_z-oKhAWQcjwgB5egzck4lqzLHYHCg",10,9,5943,4860,1083,"Aliquam quis turpis eget elit sodales scelerisque. Mauris sit amet eros. Suspendisse accumsan tortor quis turpis.",30,962,49,1.8,1360,627,733
224,"Elvis Meets Nixon",1989,"https://www.youtube.com/embed/keo8PJecIEc","https://encrypted-tbn0.gstatic.com/images?q=tbn:ANd9GcS5gl0DLTFbt7bYHEmtfUaWEKVmT1jfD8Td6ILXO_YOKSFekX9e",60,1.7,7393,8629,-1236,"Aliquam quis turpis eget elit sodales scelerisque. Mauris sit amet eros. Suspendisse accumsan tortor quis turpis.",42,4828,9,9.3,12,263,-251
225,"Sky Fighters (Les Chevaliers Du Ciel)",1999,"https://www.youtube.com/embed/2BoyDp49C6Y","https://encrypted-tbn0.gstatic.com/images?q=tbn:ANd9GcR_EXv1N1pkhMX0O3KAJXlTgC0_KL4WpSRDxUzH2CO9RPypuvxDAw",56,6.1,5704,2001,3703,"Vestibulum quam sapien, varius ut, blandit non, interdum in, ante. Vestibulum ante ipsum primis in faucibus orci luctus et ultrices posuere cubilia Curae; Duis faucibus accumsan odio. Curabitur convallis.",26,2629,20,7.5,198,3607,-3409
226,"Gunday",1994,"https://www.youtube.com/embed/G9T_f7DjYho","https://encrypted-tbn0.gstatic.com/images?q=tbn:ANd9GcQoGIgMrMpVA2TiWG8g9ENb7x-ZrciYB-gqzjyCnG-C2EgT8ePfkA",55,3.9,9822,2311,7511,"Cum sociis natoque penatibus et magnis dis parturient montes, nascetur ridiculus mus. Vivamus vestibulum sagittis sapien. Cum sociis natoque penatibus et magnis dis parturient montes, nascetur ridiculus mus.",82,9885,6,4.8,3624,2198,1426
227,"When Time Ran Out...",2012,"https://www.youtube.com/embed/iaM3y7uDL90","https://encrypted-tbn0.gstatic.com/images?q=tbn:ANd9GcSflOt4SdSx3LCTNP7im_XpsqHeeK_V_ltLPZEnK4mLjl4Eja_t",9,8.4,6386,73,6313,"Morbi non lectus. Aliquam sit amet diam in magna bibendum imperdiet. Nullam orci pede, venenatis non, sodales sed, tincidunt eu, felis.",68,2413,48,6.9,6734,5515,1219
228,"The Living Magoroku",2005,"https://www.youtube.com/embed/2FbDY0MeJf8","https://encrypted-tbn0.gstatic.com/images?q=tbn:ANd9GcSabPrm9QL3aakFmkc9kWlHSQ9uzP10Yf493F57vDv3FicybY8YIg",60,6.3,5542,1865,3677,"Donec diam neque, vestibulum eget, vulputate ut, ultrices vel, augue. Vestibulum ante ipsum primis in faucibus orci luctus et ultrices posuere cubilia Curae; Donec pharetra, magna vestibulum aliquet ultrices, erat tortor sollicitudin mi, sit amet lobortis sapien sapien non mi. Integer ac neque.",42,3441,22,6.8,3624,4860,-1236
229,"Breaking the Silence: Truth and Lies in the War on Terror",1997,"https://www.youtube.com/embed/-6jCNhebfg8","https://encrypted-tbn0.gstatic.com/images?q=tbn:ANd9GcR_EXv1N1pkhMX0O3KAJXlTgC0_KL4WpSRDxUzH2CO9RPypuvxDAw",4,6.9,284,1496,-1212,"Cras non velit nec nisi vulputate nonummy. Maecenas tincidunt lacus at velit. Vivamus vel nulla eget eros elementum pellentesque.",86,281,81,3.6,3624,4712,-1088
230,"Block-Heads",2004,"https://www.youtube.com/embed/eAIjuMHKEiA","https://encrypted-tbn0.gstatic.com/images?q=tbn:ANd9GcTiS27rf1ltLwxOAbTBhYvqJuvJG8ctIALtoknQh7MHlvV3r0UO",96,6.9,8454,1025,7429,"Curabitur in libero ut massa volutpat convallis. Morbi odio odio, elementum eu, interdum eu, tincidunt in, leo. Maecenas pulvinar lobortis est.",50,5002,28,8.4,2481,4,2477
231,"Aloft",2006,"https://www.youtube.com/embed/DIOW-kR_ams","https://encrypted-tbn0.gstatic.com/images?q=tbn:ANd9GcQzrbGfcJ8GKN78hn-r1fcQf4zH81e0MlsuOddkBJvhC5RvfF2DNw",19,1.5,2883,3563,-680,"In congue. Etiam justo. Etiam pretium iaculis justo.",100,5410,61,6.8,2016,3881,-1865
232,"The Wrong Move",2012,"https://www.youtube.com/embed/iW3t_wUDG5U","https://i.pinimg.com/236x/3b/29/73/3b2973cc00e87a821ad68647747259be--pattern-texture-paints.jpg",56,3.6,7715,5206,2509,"Suspendisse potenti. In eleifend quam a odio. In hac habitasse platea dictumst.",64,3119,4,9,9496,2489,7007
233,"Quand je serai petit",2010,"https://www.youtube.com/embed/Bn9iowpSWRs","https://encrypted-tbn0.gstatic.com/images?q=tbn:ANd9GcSfenuQRjGbddBAE4j3I_GN73Ch-EI9uairOfxWWbLQYAluLoDWCQ",22,3.2,5146,3371,1775,"Nam ultrices, libero non mattis pulvinar, nulla pede ullamcorper augue, a suscipit nulla elit ac nulla. Sed vel enim sit amet nunc viverra dapibus. Nulla suscipit ligula in lacus.",58,8234,56,3.2,7715,5471,2244
234,"The Cell 2",1998,"https://www.youtube.com/embed/ee1172yeqyE","https://encrypted-tbn0.gstatic.com/images?q=tbn:ANd9GcSkP7ePajJciblvooQK7qTSV2J0ZdjBzPxrRi7NvBHdmOLYWeT4",44,1.1,8429,831,7598,"Proin eu mi. Nulla ac enim. In tempor, turpis nec euismod scelerisque, quam turpis adipiscing lorem, vitae mattis nibh ligula nec sem.",76,2153,3,7.7,6469,4,6465
235,"Joe Kidd",2008,"https://www.youtube.com/embed/YWbrTLsplyA","https://encrypted-tbn0.gstatic.com/images?q=tbn:ANd9GcToWUNrpDN1sKiQrTBrAPVZaaHkjYWkdwsMh5Igburh2w20IPRs",68,8.9,7683,3412,4271,"Curabitur in libero ut massa volutpat convallis. Morbi odio odio, elementum eu, interdum eu, tincidunt in, leo. Maecenas pulvinar lobortis est.",26,1528,24,9.3,6579,1822,4757
236,"The Story of Xinghua",2001,"https://www.youtube.com/embed/DyQ8PoBV_Vo","https://encrypted-tbn0.gstatic.com/images?q=tbn:ANd9GcR6OdK3cVIVUn07PmO7zFQb1JyTfdi6L4FwxFWOD9dfwTwN4hEt",28,8.9,2323,8004,-5681,"Sed ante. Vivamus tortor. Duis mattis egestas metus.",76,4185,41,9,2323,4860,-2537
237,"When Time Ran Out...",1997,"https://www.youtube.com/embed/HwWWws3kzKg","https://encrypted-tbn0.gstatic.com/images?q=tbn:ANd9GcQN3_I47i-MkaTBmK9e2PzNkhGoJsWeB5U_dn5cat3hDSHLCPjU",45,9.6,8454,3771,4683,"Fusce posuere felis sed lacus. Morbi sem mauris, laoreet ut, rhoncus aliquet, pulvinar sed, nisl. Nunc rhoncus dui vel sem.",56,1528,28,4.3,9585,3771,5814
238,"The Wrong Move",1998,"https://www.youtube.com/embed/VccwBGgyzP4","https://encrypted-tbn0.gstatic.com/images?q=tbn:ANd9GcRZ2qgbwUkZMB6Z3KUBla8OIzYNOBzMaNpoAeNofRYZj8V27vwD",29,8.5,2795,2311,484,"Curabitur in libero ut massa volutpat convallis. Morbi odio odio, elementum eu, interdum eu, tincidunt in, leo. Maecenas pulvinar lobortis est.",62,7702,7,2.1,4108,3527,581
239,"Murder Ahoy",2001,"https://www.youtube.com/embed/ka3J1sUhQ4M","https://encrypted-tbn0.gstatic.com/images?q=tbn:ANd9GcSsoy4iP--KOCJ5pPhAcbfrQSvWLPYPI3I557hNf2Vfb6OrfrOczg",82,4.1,3624,1983,1641,"Proin leo odio, porttitor id, consequat in, consequat ut, nulla. Sed accumsan felis. Ut at dolor quis odio consequat varius.",56,2822,98,1.4,9141,47,9094
240,"Transylvania",1985,"https://www.youtube.com/embed/ee12SvnnrSw","https://encrypted-tbn0.gstatic.com/images?q=tbn:ANd9GcSr9sVCqvsx-91eeqQvyCjpe4Fo7sap42UGJTn3IzdyIQVFy39R",61,1,2409,537,1872,"Aliquam quis turpis eget elit sodales scelerisque. Mauris sit amet eros. Suspendisse accumsan tortor quis turpis.",68,4526,98,3.9,2016,361,1655
241,"The Stars Fell on Henrietta",1997,"https://www.youtube.com/embed/B12REtkl2KY","https://encrypted-tbn0.gstatic.com/images?q=tbn:ANd9GcRJqLpbXoWWpbGuNXVAuF8Iy2X8EFCKx-z2jPdj5XGEL_wrFgzY",83,1.2,198,305,-107,"Nulla ut erat id mauris vulputate elementum. Nullam varius. Nulla facilisi.",26,4828,77,3.2,698,4125,-3427
242,"The Big Trail",2012,"https://www.youtube.com/embed/VUEaDUyeTR8","https://encrypted-tbn0.gstatic.com/images?q=tbn:ANd9GcTjDxlkO4SurlCq11A009Vm2yOW0XT4x5GHflg-pkVrTiqWURnydg",59,3.6,9496,1592,7904,"Fusce posuere felis sed lacus. Morbi sem mauris, laoreet ut, rhoncus aliquet, pulvinar sed, nisl. Nunc rhoncus dui vel sem.",98,1442,81,9.6,8429,3251,5178
243,"Another Woman",2012,"https://www.youtube.com/embed/Sw_5YPAf7Zs","https://encrypted-tbn0.gstatic.com/images?q=tbn:ANd9GcSJJAS-aY5yM_o538SFwYJKMI1ICZvCAEdnVZX59tINRulVx7aBpA",77,1.8,2779,781,1998,"Nam ultrices, libero non mattis pulvinar, nulla pede ullamcorper augue, a suscipit nulla elit ac nulla. Sed vel enim sit amet nunc viverra dapibus. Nulla suscipit ligula in lacus.",50,458,18,1,753,4712,-3959
244,"When Time Ran Out...",2012,"https://www.youtube.com/embed/YVYzxm_RqMg","https://encrypted-tbn0.gstatic.com/images?q=tbn:ANd9GcSnUCe3jwoe6TiIdg0tv_j25Q3WHNDjeBfzqlYhOl70hy95_k9t1Q",61,8.3,5498,6494,-996,"Maecenas tristique, est et tempus semper, est quam pharetra magna, ac consequat metus sapien ut nunc. Vestibulum ante ipsum primis in faucibus orci luctus et ultrices posuere cubilia Curae; Mauris viverra diam vitae quam. Suspendisse potenti.",52,4907,28,8.3,5541,1545,3996
245,"Second Wind (Le deuxième souffle) (Second Breath)",2007,"https://www.youtube.com/embed/EKGATzNnr8c","https://encrypted-tbn0.gstatic.com/images?q=tbn:ANd9GcTTLFfQrJmhvXjL4d_udm6Z89QYglVi4hTEmbaDRdDoqHQsaQVg",29,8.4,7762,1025,6737,"Proin leo odio, porttitor id, consequat in, consequat ut, nulla. Sed accumsan felis. Ut at dolor quis odio consequat varius.",58,6777,40,9.5,9994,8629,1365
246,"Of Love and Shadows",2008,"https://www.youtube.com/embed/dfUJm6XgD7g","https://encrypted-tbn0.gstatic.com/images?q=tbn:ANd9GcQvLz9_jwOs-MucEN-bWUhjq9aaYyfVvyNoFoGgGFdFJBMuXq1yqw",33,1.8,5160,7462,-2302,"Proin eu mi. Nulla ac enim. In tempor, turpis nec euismod scelerisque, quam turpis adipiscing lorem, vitae mattis nibh ligula nec sem.",24,2413,36,3.2,7683,879,6804
247,"Poolboy: Drowning Out the Fury",1997,"https://www.youtube.com/embed/DIOW-kR_ams","https://encrypted-tbn0.gstatic.com/images?q=tbn:ANd9GcQj3o8UxHr9-tOcX5N5ppAE1Y9EZS5-9IYjKEogAzmsetJB5g0w",33,7.2,4108,2308,1800,"Sed ante. Vivamus tortor. Duis mattis egestas metus.",56,4091,49,8.1,4602,1025,3577
248,"U2: Rattle and Hum",2011,"https://www.youtube.com/embed/BQcvHEkGaEA","https://encrypted-tbn0.gstatic.com/images?q=tbn:ANd9GcRyMl7AW_r-FXiuqUSSUA5Mww484NZ8QAd_-vEbcfX2bB8j-uCn1g",44,9.5,2795,1898,897,"In hac habitasse platea dictumst. Etiam faucibus cursus urna. Ut tellus.",24,7146,26,4.6,3890,4124,-234
249,"Little Giants",1989,"https://www.youtube.com/embed/iOMxsy8S7hk","https://encrypted-tbn0.gstatic.com/images?q=tbn:ANd9GcSRkE8RSex-89LA2Msfb1Vq6eH047lvDYppmp9IwK2zLgw2nbE-Uw",49,3.8,8611,156,8455,"Curabitur in libero ut massa volutpat convallis. Morbi odio odio, elementum eu, interdum eu, tincidunt in, leo. Maecenas pulvinar lobortis est.",50,8065,38,5.4,3417,176,3241
250,"Hardcore",2011,"https://www.youtube.com/embed/fnLjm_yL7vE","https://encrypted-tbn0.gstatic.com/images?q=tbn:ANd9GcRboE_Oz4pmq_fbkSzc09GrZ6-FxQU9Zh64Y6b3LNLomLOlE4VEzQ",94,8.5,8437,156,8281,"Cras non velit nec nisi vulputate nonummy. Maecenas tincidunt lacus at velit. Vivamus vel nulla eget eros elementum pellentesque.",56,8647,55,1,5943,898,5045
251,"In the Line of Duty: The F.B.I. Murders",2005,"https://www.youtube.com/embed/7Yz10uCVNVk","https://encrypted-tbn0.gstatic.com/images?q=tbn:ANd9GcQX7g7WDTuGnT2syPcShrXK1gFJn4uMaACeAnWvesheIZXX58K1",7,6,6755,2777,3978,"Phasellus in felis. Donec semper sapien a libero. Nam dui.",66,2822,59,1,5498,3074,2424
252,"The Sword of Doom",2005,"https://www.youtube.com/embed/cYAtvv-wopk","https://encrypted-tbn0.gstatic.com/images?q=tbn:ANd9GcQ5LAO-oqK_jHF33R_asKWptHCRYc_456jcsgrngpU6q8htwl24",43,4.8,4286,6554,-2268,"Curabitur in libero ut massa volutpat convallis. Morbi odio odio, elementum eu, interdum eu, tincidunt in, leo. Maecenas pulvinar lobortis est.",38,1620,33,5.7,8382,7219,1163
253,"Alive",2004,"https://www.youtube.com/embed/VUEaDUyeTR8","https://encrypted-tbn0.gstatic.com/images?q=tbn:ANd9GcQInYhbERWHKRlaq1eJAqZqaGQ9zndtpCyGofdPFToPGHuZUGCS",64,7.2,5943,562,5381,"Quisque id justo sit amet sapien dignissim vestibulum. Vestibulum ante ipsum primis in faucibus orci luctus et ultrices posuere cubilia Curae; Nulla dapibus dolor vel est. Donec odio justo, sollicitudin ut, suscipit a, feugiat et, eros.",70,1589,95,2.1,5704,1898,3806
254,"The Big Trail",1998,"https://www.youtube.com/embed/dfUJm6XgD7g","https://encrypted-tbn0.gstatic.com/images?q=tbn:ANd9GcQT7MRD7KMXMfYFZ3Qi33LI-_bu1Q0DxOyhQgqolg06W2PrTbVuWg",70,3.9,753,6885,-6132,"Fusce consequat. Nulla nisl. Nunc nisl.",34,1317,64,4.7,4324,5,4319
255,"Harry Potter and the Order of the Phoenix",2011,"https://www.youtube.com/embed/iOMxsy8S7hk","https://encrypted-tbn0.gstatic.com/images?q=tbn:ANd9GcQX7g7WDTuGnT2syPcShrXK1gFJn4uMaACeAnWvesheIZXX58K1",88,8.4,8437,3527,4910,"Morbi porttitor lorem id ligula. Suspendisse ornare consequat lectus. In est risus, auctor sed, tristique in, tempus sit amet, sem.",22,5002,55,1.1,6774,5,6769
256,"Dorado, El",2008,"https://www.youtube.com/embed/EKGATzNnr8c","https://encrypted-tbn0.gstatic.com/images?q=tbn:ANd9GcR6OdK3cVIVUn07PmO7zFQb1JyTfdi6L4FwxFWOD9dfwTwN4hEt",60,9.7,8429,3444,4985,"Praesent blandit. Nam nulla. Integer pede justo, lacinia eget, tincidunt eget, tempus vel, pede.",58,7069,38,9.5,7683,3371,4312
257,"The Last Seduction",1994,"https://www.youtube.com/embed/78ozCL4sQoI","https://i.pinimg.com/236x/3b/29/73/3b2973cc00e87a821ad68647747259be--pattern-texture-paints.jpg",61,1.1,2409,2617,-208,"Sed ante. Vivamus tortor. Duis mattis egestas metus.",80,6868,24,5.9,9696,3648,6048
258,"Beyond Therapy",1987,"https://www.youtube.com/embed/IU3xV9ZRYlk","https://encrypted-tbn0.gstatic.com/images?q=tbn:ANd9GcQYYT2HR82Tm6jDN6B_0-JbBC3HMcVQoxrwz0iiWHkiPx0sXczovQ",26,6.2,4602,879,3723,"Fusce consequat. Nulla nisl. Nunc nisl.",50,6770,64,3.1,3458,5209,-1751
259,"Little Giants",1998,"https://www.youtube.com/embed/MNp1LPm3Krs","https://encrypted-tbn0.gstatic.com/images?q=tbn:ANd9GcSsoy4iP--KOCJ5pPhAcbfrQSvWLPYPI3I557hNf2Vfb6OrfrOczg",66,5.1,9416,305,9111,"Integer tincidunt ante vel ipsum. Praesent blandit lacinia erat. Vestibulum sed magna at nunc commodo placerat.",62,6159,96,3.6,8816,1865,6951
260,"Clifford",1985,"https://www.youtube.com/embed/tkSuLa3o_5A","https://encrypted-tbn0.gstatic.com/images?q=tbn:ANd9GcS_NoH0Aw_5YFsBFwfBPn_O7YPHXumI5V3iQ2s7B-3zPU_7sSm1gA",42,3.1,8410,7659,751,"Donec diam neque, vestibulum eget, vulputate ut, ultrices vel, augue. Vestibulum ante ipsum primis in faucibus orci luctus et ultrices posuere cubilia Curae; Donec pharetra, magna vestibulum aliquet ultrices, erat tortor sollicitudin mi, sit amet lobortis sapien sapien non mi. Integer ac neque.",30,3119,26,3.2,2987,3881,-894
261,"Dorado, El",2010,"https://www.youtube.com/embed/QJlh0IPQbbo","https://encrypted-tbn0.gstatic.com/images?q=tbn:ANd9GcSaZZLwGXqiNU5rkhexU86wKZGzymZWTp2nKRDFdITh7rD7Jb6yGA",2,6.1,1555,2606,-1051,"Quisque porta volutpat erat. Quisque erat eros, viverra eget, congue eget, semper rutrum, nulla. Nunc purus.",64,7702,62,2.1,8496,772,7724
262,"Blow Out",1996,"https://www.youtube.com/embed/qSs5zsGoqs4","https://encrypted-tbn0.gstatic.com/images?q=tbn:ANd9GcSfdl_pNap7w4wYTP7dhiozrcmHAmCcADuvkKlsj19tBpxYkq60LA",26,8.4,8429,2311,6118,"Sed sagittis. Nam congue, risus semper porta volutpat, quam pede lobortis ligula, sit amet eleifend pede libero quis orci. Nullam molestie nibh in lectus.",42,8567,65,6.8,132,8964,-8832
263,"Diary of a Shinjuku Thief (Shinjuku dorobo nikki)",1985,"https://www.youtube.com/embed/fPq4zW9QZSg","https://encrypted-tbn0.gstatic.com/images?q=tbn:ANd9GcRUlnvuLTJg0mT65nGxwZY6OfVvev6DxlvShy5w5Mpai-i6Vk6Qfg",61,3.2,9822,176,9646,"Proin eu mi. Nulla ac enim. In tempor, turpis nec euismod scelerisque, quam turpis adipiscing lorem, vitae mattis nibh ligula nec sem.",50,9441,2,1.8,5704,2240,3464
264,"Protector (Protektor)",1997,"https://www.youtube.com/embed/LcepHRTWI18","https://encrypted-tbn0.gstatic.com/images?q=tbn:ANd9GcRUMZIkgEW4ZtYyXTgo6uGdYksy7dreOkd-zJRc1uGna-GAnU3SDQ",25,3.4,6275,1037,5238,"Maecenas leo odio, condimentum id, luctus nec, molestie sed, justo. Pellentesque viverra pede ac diam. Cras pellentesque volutpat dui.",82,1317,88,9.5,7162,3428,3734
265,"Clifford",2011,"https://www.youtube.com/embed/7C2Nad0aMPg","https://encrypted-tbn0.gstatic.com/images?q=tbn:ANd9GcTiS27rf1ltLwxOAbTBhYvqJuvJG8ctIALtoknQh7MHlvV3r0UO",88,5.1,5704,3313,2391,"Quisque porta volutpat erat. Quisque erat eros, viverra eget, congue eget, semper rutrum, nulla. Nunc purus.",26,7121,41,9.6,12,2308,-2296
266,"When Time Ran Out...",2001,"https://www.youtube.com/embed/8oTXc5t35Ro","https://encrypted-tbn0.gstatic.com/images?q=tbn:ANd9GcSxYkdQhkFdrUcKH8fJB2yXGC_mRCGuYTVOQUJTDJY0t9GQ7I2_",70,3.9,8377,3118,5259,"Quisque id justo sit amet sapien dignissim vestibulum. Vestibulum ante ipsum primis in faucibus orci luctus et ultrices posuere cubilia Curae; Nulla dapibus dolor vel est. Donec odio justo, sollicitudin ut, suscipit a, feugiat et, eros.",26,5002,9,1.8,6801,1214,5587
267,"Vicky Donor",2010,"https://www.youtube.com/embed/MPWMBITCudM","https://encrypted-tbn0.gstatic.com/images?q=tbn:ANd9GcQKE0-ggtSuRrbc-0BlaVgTBu4zGwn22cMB8tEdwr9uHJJ9jXGs",83,1.2,2269,1504,765,"Cras non velit nec nisi vulputate nonummy. Maecenas tincidunt lacus at velit. Vivamus vel nulla eget eros elementum pellentesque.",74,2682,80,7.7,7146,8004,-858
268,"Second Wind (Le deuxième souffle) (Second Breath)",1996,"https://www.youtube.com/embed/kWuwuQ0X9OA","https://encrypted-tbn0.gstatic.com/images?q=tbn:ANd9GcQvLz9_jwOs-MucEN-bWUhjq9aaYyfVvyNoFoGgGFdFJBMuXq1yqw",81,5.7,9683,2711,6972,"Quisque porta volutpat erat. Quisque erat eros, viverra eget, congue eget, semper rutrum, nulla. Nunc purus.",82,6139,64,9,692,3251,-2559
269,"The King",1977,"https://www.youtube.com/embed/LcepHRTWI18","https://encrypted-tbn0.gstatic.com/images?q=tbn:ANd9GcSRkE8RSex-89LA2Msfb1Vq6eH047lvDYppmp9IwK2zLgw2nbE-Uw",57,6.2,2269,54,2215,"Pellentesque at nulla. Suspendisse potenti. Cras in purus eu magna vulputate luctus.",66,4907,81,5.9,6199,215,5984
270,"The Tic Code",2011,"https://www.youtube.com/embed/9gWsyEkKO1A","https://encrypted-tbn0.gstatic.com/images?q=tbn:ANd9GcQ1NxrNXukXKIzYZ8UbVazSnR-5741v5UDQPpMMVUvn_2I28fMZ",94,3.2,1555,285,1270,"Quisque porta volutpat erat. Quisque erat eros, viverra eget, congue eget, semper rutrum, nulla. Nunc purus.",64,6858,19,1.7,8611,1822,6789
271,"The Pit, the Pendulum and Hope",2012,"https://www.youtube.com/embed/1ywA8TtwJ50","https://encrypted-tbn0.gstatic.com/images?q=tbn:ANd9GcSJJAS-aY5yM_o538SFwYJKMI1ICZvCAEdnVZX59tINRulVx7aBpA",7,9.6,6755,2596,4159,"Proin eu mi. Nulla ac enim. In tempor, turpis nec euismod scelerisque, quam turpis adipiscing lorem, vitae mattis nibh ligula nec sem.",86,6858,24,6.1,6072,361,5711
272,"The Last Seduction",2002,"https://www.youtube.com/embed/KbZ3TVEkuDY","https://encrypted-tbn0.gstatic.com/images?q=tbn:ANd9GcTZmxe1lfZxGWCEdh5BIO8o0IWoInXoMB0QURL9yFrayrcsRK7J",45,7.7,5943,3371,2572,"Proin eu mi. Nulla ac enim. In tempor, turpis nec euismod scelerisque, quam turpis adipiscing lorem, vitae mattis nibh ligula nec sem.",50,8056,43,9.3,8446,2777,5669
273,"The Pit, the Pendulum and Hope",2010,"https://www.youtube.com/embed/iOMxsy8S7hk","https://encrypted-tbn0.gstatic.com/images?q=tbn:ANd9GcSC_qEbYtBeELogQVPTeiWNRbcOXlYKbMYmMPaG67T_yrWKEiTV",28,1.2,6386,5284,1102,"Proin eu mi. Nulla ac enim. In tempor, turpis nec euismod scelerisque, quam turpis adipiscing lorem, vitae mattis nibh ligula nec sem.",28,9683,98,2.8,6734,3412,3322
274,"Talcum Powder",2001,"https://www.youtube.com/embed/hvDwA_EDcOQ","https://encrypted-tbn0.gstatic.com/images?q=tbn:ANd9GcR6OdK3cVIVUn07PmO7zFQb1JyTfdi6L4FwxFWOD9dfwTwN4hEt",82,3.1,9496,2777,6719,"Praesent blandit. Nam nulla. Integer pede justo, lacinia eget, tincidunt eget, tempus vel, pede.",42,735,17,6.9,2777,7659,-4882
275,"Tis kakomoiras",1968,"https://www.youtube.com/embed/eqDHqOcXjRQ","https://encrypted-tbn0.gstatic.com/images?q=tbn:ANd9GcSmZDfgAQh9gNhDHM4YtECFcKd6iXDTMrn-PXI6Wylc9Lddn5ah-w",26,1.1,6199,2489,3710,"Cum sociis natoque penatibus et magnis dis parturient montes, nascetur ridiculus mus. Vivamus vestibulum sagittis sapien. Cum sociis natoque penatibus et magnis dis parturient montes, nascetur ridiculus mus.",28,6593,49,6.9,6734,4196,2538
276,"The Possession of Michael King",1988,"https://www.youtube.com/embed/4AEkzL2SvmI","https://encrypted-tbn0.gstatic.com/images?q=tbn:ANd9GcRyMl7AW_r-FXiuqUSSUA5Mww484NZ8QAd_-vEbcfX2bB8j-uCn1g",77,8.4,4286,3428,858,"Praesent blandit. Nam nulla. Integer pede justo, lacinia eget, tincidunt eget, tempus vel, pede.",38,1528,2,9.1,8816,7659,1157
277,"Jin Roh: The Wolf Brigade (Jin-Rô)",1988,"https://www.youtube.com/embed/SF0w2B6DNUE","https://encrypted-tbn0.gstatic.com/images?q=tbn:ANd9GcQvfJ-vLQ5TK13ND8sY6H-r6cm_4f3SnW_WAWn2vuX-nGh6F8JquQ",2,4.1,3801,2999,802,"Cras non velit nec nisi vulputate nonummy. Maecenas tincidunt lacus at velit. Vivamus vel nulla eget eros elementum pellentesque.",28,3776,56,5.1,132,3251,-3119
278,"Breaking the Silence: Truth and Lies in the War on Terror",1999,"https://www.youtube.com/embed/3svtRyLq3b0","https://encrypted-tbn0.gstatic.com/images?q=tbn:ANd9GcSabPrm9QL3aakFmkc9kWlHSQ9uzP10Yf493F57vDv3FicybY8YIg",28,6.3,8226,5206,3020,"Morbi porttitor lorem id ligula. Suspendisse ornare consequat lectus. In est risus, auctor sed, tristique in, tempus sit amet, sem.",44,8485,70,3.4,7393,3421,3972
279,"The Innocent",2008,"https://www.youtube.com/embed/iW3t_wUDG5U","https://encrypted-tbn0.gstatic.com/images?q=tbn:ANd9GcQ4tG7BC0SE2SNUji4NBAmTKKl13L-IuMZpkiEbQm0YeWk9Z1SQUg",22,9.3,2269,8629,-6360,"Donec diam neque, vestibulum eget, vulputate ut, ultrices vel, augue. Vestibulum ante ipsum primis in faucibus orci luctus et ultrices posuere cubilia Curae; Donec pharetra, magna vestibulum aliquet ultrices, erat tortor sollicitudin mi, sit amet lobortis sapien sapien non mi. Integer ac neque.",96,9805,57,8.8,6869,6554,315
280,"The Gaucho",1996,"https://www.youtube.com/embed/1ywA8TtwJ50","https://encrypted-tbn0.gstatic.com/images?q=tbn:ANd9GcToWUNrpDN1sKiQrTBrAPVZaaHkjYWkdwsMh5Igburh2w20IPRs",98,2.8,2795,781,2014,"In quis justo. Maecenas rhoncus aliquam lacus. Morbi quis tortor id nulla ultrices aliquet.",86,2413,19,4.4,4108,3607,501
281,"The Big Trail",2002,"https://www.youtube.com/embed/ocWpGdITSR4","https://encrypted-tbn0.gstatic.com/images?q=tbn:ANd9GcQvfJ-vLQ5TK13ND8sY6H-r6cm_4f3SnW_WAWn2vuX-nGh6F8JquQ",90,2.1,698,2001,-1303,"Sed sagittis. Nam congue, risus semper porta volutpat, quam pede lobortis ligula, sit amet eleifend pede libero quis orci. Nullam molestie nibh in lectus.",100,7690,44,2.4,5498,1575,3923
282,"AVPR: Aliens vs. Predator - Requiem",2012,"https://www.youtube.com/embed/7C2Nad0aMPg","https://encrypted-tbn0.gstatic.com/images?q=tbn:ANd9GcSRkE8RSex-89LA2Msfb1Vq6eH047lvDYppmp9IwK2zLgw2nbE-Uw",56,5.8,9994,2617,7377,"Maecenas tristique, est et tempus semper, est quam pharetra magna, ac consequat metus sapien ut nunc. Vestibulum ante ipsum primis in faucibus orci luctus et ultrices posuere cubilia Curae; Mauris viverra diam vitae quam. Suspendisse potenti.",30,4526,78,4.1,7383,5209,2174
283,"The King",1997,"https://www.youtube.com/embed/YVYzxm_RqMg","https://encrypted-tbn0.gstatic.com/images?q=tbn:ANd9GcSC_qEbYtBeELogQVPTeiWNRbcOXlYKbMYmMPaG67T_yrWKEiTV",49,4.1,5696,879,4817,"Proin eu mi. Nulla ac enim. In tempor, turpis nec euismod scelerisque, quam turpis adipiscing lorem, vitae mattis nibh ligula nec sem.",76,4828,94,7.7,4286,2606,1680
284,"Operation 'Y' & Other Shurik's Adventures",2012,"https://www.youtube.com/embed/8W6yYBAUxv4","https://i.pinimg.com/236x/77/50/b3/7750b3ebe0787ae8e9beb7e2615e3b01.jpg",26,2.9,3411,2596,815,"Curabitur at ipsum ac tellus semper interdum. Mauris ullamcorper purus sit amet nulla. Quisque arcu libero, rutrum ac, lobortis vel, dapibus at, diam.",30,7612,20,2.4,132,1545,-1413
285,"From Beijing with Love",2012,"https://www.youtube.com/embed/oNTzFnMXT3E","https://encrypted-tbn0.gstatic.com/images?q=tbn:ANd9GcSnUCe3jwoe6TiIdg0tv_j25Q3WHNDjeBfzqlYhOl70hy95_k9t1Q",98,4.3,9416,5,9411,"In quis justo. Maecenas rhoncus aliquam lacus. Morbi quis tortor id nulla ultrices aliquet.",54,2413,13,1.8,3530,6427,-2897
286,"Condorman",1994,"https://www.youtube.com/embed/eAIjuMHKEiA","https://encrypted-tbn0.gstatic.com/images?q=tbn:ANd9GcT8fsnqcp8Y3Y2dxkM4H8TJyS7bRYttijiNFZ-mruoqpzO29uM7",57,3.4,6006,2777,3229,"Fusce posuere felis sed lacus. Morbi sem mauris, laoreet ut, rhoncus aliquet, pulvinar sed, nisl. Nunc rhoncus dui vel sem.",38,2667,89,1.2,2847,2999,-152
287,"Overnight Delivery",2005,"https://www.youtube.com/embed/6Ui6m_eEEOI","https://encrypted-tbn0.gstatic.com/images?q=tbn:ANd9GcQhhglaTqXYejQ2b9TYl15F3E4pAgR1pWjyYyUTJgkHGuKsiWyHrw",70,3.1,3530,2198,1332,"Morbi non lectus. Aliquam sit amet diam in magna bibendum imperdiet. Nullam orci pede, venenatis non, sodales sed, tincidunt eu, felis.",58,458,3,9.7,8611,2596,6015
288,"Elvis Meets Nixon",1996,"https://www.youtube.com/embed/h-k0-Z9b4Cw","https://encrypted-tbn0.gstatic.com/images?q=tbn:ANd9GcSYy4S-T_nbr708KkpYcV-RgmyX_MPtCXzFVr44X7S9CAQsyQAE3Q",6,8.4,6801,3771,3030,"Sed ante. Vivamus tortor. Duis mattis egestas metus.",96,1589,3,3.9,118,5,113
289,"The Sword of Doom",2007,"https://www.youtube.com/embed/OWwVD1xdAX4","https://encrypted-tbn0.gstatic.com/images?q=tbn:ANd9GcQ--11hFR6GYIOagDhcOJiqKSIqKz7XB_wRhQklbSwf9d4k8lto",83,6.7,7393,2240,5153,"Nulla ut erat id mauris vulputate elementum. Nullam varius. Nulla facilisi.",64,8013,50,1.8,2733,3563,-830
290,"The Indian Runner",2003,"https://www.youtube.com/embed/8W6yYBAUxv4","https://encrypted-tbn0.gstatic.com/images?q=tbn:ANd9GcSkjHflFbGJwA3Dk6FW71ynZ5C6z_y9dkcX7Q0Q-2NSkRIUerlH",42,8.1,6869,6885,-16,"Mauris enim leo, rhoncus sed, vestibulum sit amet, cursus id, turpis. Integer aliquet, massa id lobortis convallis, tortor risus dapibus augue, vel accumsan tellus nisi eu orci. Mauris lacinia sapien quis libero.",96,9178,33,6.9,2795,1025,1770
291,"Little Boy Blue",1999,"https://www.youtube.com/embed/BQcvHEkGaEA","https://i.pinimg.com/736x/37/a0/99/37a099570abb65e478268af396315658--brochure-design-colour-combinations.jpg",98,9.1,7683,923,6760,"Maecenas leo odio, condimentum id, luctus nec, molestie sed, justo. Pellentesque viverra pede ac diam. Cras pellentesque volutpat dui.",52,6139,26,3.2,6774,2596,4178
292,"Blow Out",2006,"https://www.youtube.com/embed/giIs-AEAX6Y","https://encrypted-tbn0.gstatic.com/images?q=tbn:ANd9GcT11kibbY7ZQKvhvKatIRRKfv-n-n77Ve-QuVdMOoMg-fol_k9j",89,2.1,5146,4020,1126,"Proin eu mi. Nulla ac enim. In tempor, turpis nec euismod scelerisque, quam turpis adipiscing lorem, vitae mattis nibh ligula nec sem.",86,9683,89,7.2,198,781,-583
293,"The Gaucho",2010,"https://www.youtube.com/embed/qqlEGYo0xCA","https://encrypted-tbn0.gstatic.com/images?q=tbn:ANd9GcSAeZgM34QBLW9W6aAQ7xBcJIa1KwtfVVcFHkKpsxvOjDBmNvh0",69,3.6,2409,3412,-1003,"Donec diam neque, vestibulum eget, vulputate ut, ultrices vel, augue. Vestibulum ante ipsum primis in faucibus orci luctus et ultrices posuere cubilia Curae; Donec pharetra, magna vestibulum aliquet ultrices, erat tortor sollicitudin mi, sit amet lobortis sapien sapien non mi. Integer ac neque.",50,2667,57,6.9,4286,1037,3249
294,"Vicky Donor",2010,"https://www.youtube.com/embed/yuYoFVHkvIA","https://encrypted-tbn0.gstatic.com/images?q=tbn:ANd9GcTppyYABMyqegOc4I6b3NS0iUaX0R6Cy1-PlahMrPPUzzqPNux9Gg",66,3.4,2481,3771,-1290,"Cras mi pede, malesuada in, imperdiet et, commodo vulputate, justo. In blandit ultrices enim. Lorem ipsum dolor sit amet, consectetuer adipiscing elit.",64,1115,36,6,8410,1504,6906
295,"Jin Roh: The Wolf Brigade (Jin-Rô)",2006,"https://www.youtube.com/embed/eAIjuMHKEiA","https://encrypted-tbn0.gstatic.com/images?q=tbn:ANd9GcSfenuQRjGbddBAE4j3I_GN73Ch-EI9uairOfxWWbLQYAluLoDWCQ",10,4.2,8437,1590,6847,"Morbi non lectus. Aliquam sit amet diam in magna bibendum imperdiet. Nullam orci pede, venenatis non, sodales sed, tincidunt eu, felis.",50,8065,81,3.2,8410,1865,6545
296,"The Innocent",2011,"https://www.youtube.com/embed/kWuwuQ0X9OA","https://encrypted-tbn0.gstatic.com/images?q=tbn:ANd9GcRxLYJSuzc9AAuuJ3R1HulbKM_T8_whdwPZQj7VyYonHOME6fYq",43,7.5,3801,361,3440,"Cum sociis natoque penatibus et magnis dis parturient montes, nascetur ridiculus mus. Vivamus vestibulum sagittis sapien. Cum sociis natoque penatibus et magnis dis parturient montes, nascetur ridiculus mus.",88,8135,33,2.1,8388,1560,6828
297,"The Poseidon Adventure",1987,"https://www.youtube.com/embed/8oTXc5t35Ro","https://encrypted-tbn0.gstatic.com/images?q=tbn:ANd9GcQtbFBdNfjGVCo1GPJC_9PUkUc7wRIwwh0PMwS76SEP_QTtAyat",90,2.4,6579,627,5952,"Sed ante. Vivamus tortor. Duis mattis egestas metus.",40,9382,7,9.6,7162,156,7006
298,"The Possession of Michael King",1995,"https://www.youtube.com/embed/mAX1oGLvMAA","https://encrypted-tbn0.gstatic.com/images?q=tbn:ANd9GcTZlJW6ILTHoyypnMTvpWTFl3IhTXHYM5kQntofSVvdKEozMRsTxQ",95,1.2,6199,537,5662,"In sagittis dui vel nisl. Duis ac nibh. Fusce lacus purus, aliquet at, feugiat non, pretium quis, lectus.",38,1277,49,4.6,8382,3563,4819
299,"Man Is Not a Bird (Covek nije tica)",1999,"https://www.youtube.com/embed/zCecE7OyVMU","https://encrypted-tbn0.gstatic.com/images?q=tbn:ANd9GcS0uoN_00qCw12_q1GgGAdcbA-6sp6JzFguYZMxLObI8Ydh9OBk",98,3.2,3624,1733,1891,"Proin leo odio, porttitor id, consequat in, consequat ut, nulla. Sed accumsan felis. Ut at dolor quis odio consequat varius.",28,1277,66,5.4,9994,3313,6681
300,"7 Women (a.k.a. Seven Women)",1997,"https://www.youtube.com/embed/XtgCqMZofqM","https://encrypted-tbn0.gstatic.com/images?q=tbn:ANd9GcQaa7JH1TX7xtU8SpR35IjPOWF7HSujPYnfqJy-FlHEfxv6HXq3tQ",70,5.9,2016,2999,-983,"Maecenas ut massa quis augue luctus tincidunt. Nulla mollis molestie lorem. Quisque ut erat.",74,8567,89,6,2034,3563,-1529
301,"AVPR: Aliens vs. Predator - Requiem",2006,"https://www.youtube.com/embed/MpJEOpsVWtA","https://encrypted-tbn0.gstatic.com/images?q=tbn:ANd9GcQaa7JH1TX7xtU8SpR35IjPOWF7HSujPYnfqJy-FlHEfxv6HXq3tQ",70,6.2,5541,1061,4480,"Proin eu mi. Nulla ac enim. In tempor, turpis nec euismod scelerisque, quam turpis adipiscing lorem, vitae mattis nibh ligula nec sem.",96,2866,49,9.7,284,3421,-3137
302,"Aloft",1998,"https://www.youtube.com/embed/iaM3y7uDL90","https://encrypted-tbn0.gstatic.com/images?q=tbn:ANd9GcQ06LkOABmCBkCQO4wr6V0tHNUOyUYNR-YLaEHAblZo1ZqlooBmOg",88,3.6,5529,1545,3984,"Sed sagittis. Nam congue, risus semper porta volutpat, quam pede lobortis ligula, sit amet eleifend pede libero quis orci. Nullam molestie nibh in lectus.",88,3444,98,8.8,132,213,-81
303,"The Last Seduction",1998,"https://www.youtube.com/embed/VccwBGgyzP4","https://encrypted-tbn0.gstatic.com/images?q=tbn:ANd9GcRmeUcg7O8EkPtcOaGTwx1hvLuj5TbCPLmfq_zT0IhPpcbOWbBUDA",56,2.8,8377,5228,3149,"Curabitur in libero ut massa volutpat convallis. Morbi odio odio, elementum eu, interdum eu, tincidunt in, leo. Maecenas pulvinar lobortis est.",40,5410,96,8.9,3923,1504,2419
304,"Man Is Not a Bird (Covek nije tica)",2004,"https://www.youtube.com/embed/nmGmu-knybU","https://encrypted-tbn0.gstatic.com/images?q=tbn:ANd9GcSnUCe3jwoe6TiIdg0tv_j25Q3WHNDjeBfzqlYhOl70hy95_k9t1Q",31,5.8,5541,4712,829,"Vestibulum quam sapien, varius ut, blandit non, interdum in, ante. Vestibulum ante ipsum primis in faucibus orci luctus et ultrices posuere cubilia Curae; Duis faucibus accumsan odio. Curabitur convallis.",22,8234,78,8.9,9496,5515,3981
305,"Dr. Jekyll and Ms. Hyde",2001,"https://www.youtube.com/embed/ee1172yeqyE","https://encrypted-tbn0.gstatic.com/images?q=tbn:ANd9GcQj3o8UxHr9-tOcX5N5ppAE1Y9EZS5-9IYjKEogAzmsetJB5g0w",2,1.8,7256,8629,-1373,"Integer tincidunt ante vel ipsum. Praesent blandit lacinia erat. Vestibulum sed magna at nunc commodo placerat.",88,8485,61,5.7,753,156,597
306,"The Tic Code",2000,"https://www.youtube.com/embed/VccwBGgyzP4","https://encrypted-tbn0.gstatic.com/images?q=tbn:ANd9GcTrBuPeRIXbqvHjWMwFg1aZvVkw71rsNVla5A067w7kiY-DPB7N",69,3.2,6175,831,5344,"Cum sociis natoque penatibus et magnis dis parturient montes, nascetur ridiculus mus. Vivamus vestibulum sagittis sapien. Cum sociis natoque penatibus et magnis dis parturient montes, nascetur ridiculus mus.",86,3074,22,9.5,6199,3412,2787
307,"The Paradine Case",1991,"https://www.youtube.com/embed/qSs5zsGoqs4","https://encrypted-tbn0.gstatic.com/images?q=tbn:ANd9GcRTcG2_JqWMZJOf6uyZm7vI1GQGSsjWkKgxCokuA40pthaOj9LOFQ",98,3.9,3411,47,3364,"Fusce consequat. Nulla nisl. Nunc nisl.",64,25,98,7.2,2883,627,2256
308,"Fair Game",1995,"https://www.youtube.com/embed/zCecE7OyVMU","https://encrypted-tbn0.gstatic.com/images?q=tbn:ANd9GcQYYT2HR82Tm6jDN6B_0-JbBC3HMcVQoxrwz0iiWHkiPx0sXczovQ",10,8.3,9899,1733,8166,"Maecenas ut massa quis augue luctus tincidunt. Nulla mollis molestie lorem. Quisque ut erat.",64,2153,96,2,6662,156,6506
309,"Holy Flame of the Martial World (Wu lin sheng huo jin)",2002,"https://www.youtube.com/embed/9gWsyEkKO1A","https://encrypted-tbn0.gstatic.com/images?q=tbn:ANd9GcRfaybDSA3hF-btWMAObj0lbtp7UbFPvvC41dZ9EEL1BMISwxF6",59,3.6,3417,6366,-2949,"Morbi non lectus. Aliquam sit amet diam in magna bibendum imperdiet. Nullam orci pede, venenatis non, sodales sed, tincidunt eu, felis.",26,4828,61,2.1,284,7462,-7178
310,"The Iran Job",1984,"https://www.youtube.com/embed/COTt1zvBUJk","https://encrypted-tbn0.gstatic.com/images?q=tbn:ANd9GcRfaybDSA3hF-btWMAObj0lbtp7UbFPvvC41dZ9EEL1BMISwxF6",17,4.7,2795,2777,18,"Proin eu mi. Nulla ac enim. In tempor, turpis nec euismod scelerisque, quam turpis adipiscing lorem, vitae mattis nibh ligula nec sem.",42,4526,7,3.2,8496,6366,2130
311,"Zatoichi the Outlaw (Zatôichi rôyaburi) (Zatôichi 16)",2009,"https://www.youtube.com/embed/l-u3PdA-rpY","https://i.pinimg.com/236x/77/50/b3/7750b3ebe0787ae8e9beb7e2615e3b01.jpg",31,4.1,753,537,216,"Integer tincidunt ante vel ipsum. Praesent blandit lacinia erat. Vestibulum sed magna at nunc commodo placerat.",22,7498,81,5.1,3624,2596,1028
312,"Condorman",1986,"https://www.youtube.com/embed/HwWWws3kzKg","https://encrypted-tbn0.gstatic.com/images?q=tbn:ANd9GcQKE0-ggtSuRrbc-0BlaVgTBu4zGwn22cMB8tEdwr9uHJJ9jXGs",17,7.7,5696,1037,4659,"Sed ante. Vivamus tortor. Duis mattis egestas metus.",70,2435,69,1.2,3458,1575,1883
313,"The Big Trail",2010,"https://www.youtube.com/embed/7Yz10uCVNVk","https://encrypted-tbn0.gstatic.com/images?q=tbn:ANd9GcQhhglaTqXYejQ2b9TYl15F3E4pAgR1pWjyYyUTJgkHGuKsiWyHrw",55,6.2,3890,1374,2516,"Morbi non lectus. Aliquam sit amet diam in magna bibendum imperdiet. Nullam orci pede, venenatis non, sodales sed, tincidunt eu, felis.",22,5258,25,1.8,753,305,448
314,"AVPR: Aliens vs. Predator - Requiem",2011,"https://www.youtube.com/embed/-6jCNhebfg8","https://encrypted-tbn0.gstatic.com/images?q=tbn:ANd9GcQ-Bo62SqPu_RKYOfA9eW-LQjqldSZ02v2_G5-UJtSlr8Qd948lLA",24,2.4,6869,1374,5495,"Donec diam neque, vestibulum eget, vulputate ut, ultrices vel, augue. Vestibulum ante ipsum primis in faucibus orci luctus et ultrices posuere cubilia Curae; Donec pharetra, magna vestibulum aliquet ultrices, erat tortor sollicitudin mi, sit amet lobortis sapien sapien non mi. Integer ac neque.",26,5615,81,5.4,7146,1822,5324
315,"Poolboy: Drowning Out the Fury",2012,"https://www.youtube.com/embed/vuzplFd3YVY","https://encrypted-tbn0.gstatic.com/images?q=tbn:ANd9GcRWaaeSy6yTdILVOdHiDa9DWFAM4DhQ1JlJvUBR4vWbVoeZznD-",11,2.4,5542,1590,3952,"Praesent blandit. Nam nulla. Integer pede justo, lacinia eget, tincidunt eget, tempus vel, pede.",26,6139,49,3.2,6175,1061,5114
316,"Prince Valiant",1991,"https://www.youtube.com/embed/mAX1oGLvMAA","https://encrypted-tbn0.gstatic.com/images?q=tbn:ANd9GcSAeZgM34QBLW9W6aAQ7xBcJIa1KwtfVVcFHkKpsxvOjDBmNvh0",22,6.7,3530,47,3483,"Curabitur in libero ut massa volutpat convallis. Morbi odio odio, elementum eu, interdum eu, tincidunt in, leo. Maecenas pulvinar lobortis est.",48,4869,62,9.5,7256,2352,4904
317,"AVPR: Aliens vs. Predator - Requiem",2010,"https://www.youtube.com/embed/SF0w2B6DNUE","https://i.pinimg.com/originals/c9/ba/74/c9ba7451301a9003752d2f61b5036730.jpg",80,1.2,9994,1037,8957,"Phasellus in felis. Donec semper sapien a libero. Nam dui.",22,3455,57,5.4,8437,1061,7376
318,"Isolation",2004,"https://www.youtube.com/embed/oP-fRX_gB6o","https://encrypted-tbn0.gstatic.com/images?q=tbn:ANd9GcTohJTJK1v5tSnhy3g7gvaali5Xq0Qq6MwRJMGVD5enka23vy2H",89,2.1,8410,73,8337,"Duis bibendum. Morbi non quam nec dui luctus rutrum. Nulla tellus.",76,4907,60,6.7,9822,1496,8326
319,"Miami Vice",2010,"https://www.youtube.com/embed/oNTzFnMXT3E","https://encrypted-tbn0.gstatic.com/images?q=tbn:ANd9GcRmeUcg7O8EkPtcOaGTwx1hvLuj5TbCPLmfq_zT0IhPpcbOWbBUDA",69,3.2,3019,1983,1036,"Sed sagittis. Nam congue, risus semper porta volutpat, quam pede lobortis ligula, sit amet eleifend pede libero quis orci. Nullam molestie nibh in lectus.",50,6159,68,8.5,2269,5471,-3202
320,"The Iran Job",2000,"https://www.youtube.com/embed/ee12SvnnrSw","https://encrypted-tbn0.gstatic.com/images?q=tbn:ANd9GcTZmxe1lfZxGWCEdh5BIO8o0IWoInXoMB0QURL9yFrayrcsRK7J",57,5.7,9585,2308,7277,"Lorem ipsum dolor sit amet, consectetuer adipiscing elit. Proin risus. Praesent lectus.",86,8851,10,2.1,1555,5284,-3729
321,"The Living Magoroku",2004,"https://www.youtube.com/embed/MNp1LPm3Krs","https://i.pinimg.com/236x/77/50/b3/7750b3ebe0787ae8e9beb7e2615e3b01.jpg",56,8.3,2034,3771,-1737,"Pellentesque at nulla. Suspendisse potenti. Cras in purus eu magna vulputate luctus.",62,1589,28,1.8,284,537,-253
322,"Babylon 5: In the Beginning",1994,"https://www.youtube.com/embed/DyQ8PoBV_Vo","https://encrypted-tbn0.gstatic.com/images?q=tbn:ANd9GcQtbFBdNfjGVCo1GPJC_9PUkUc7wRIwwh0PMwS76SEP_QTtAyat",69,5.9,1360,215,1145,"Fusce consequat. Nulla nisl. Nunc nisl.",86,8056,30,8.5,4286,2777,1509
323,"The Last Seduction",1994,"https://www.youtube.com/embed/tkSuLa3o_5A","https://encrypted-tbn0.gstatic.com/images?q=tbn:ANd9GcR203qZ3CqJHkReGO_urfLpOmRqqwbZ6g8ZOVV-2aZbySbWl_abdg",61,7.5,6869,2777,4092,"Donec diam neque, vestibulum eget, vulputate ut, ultrices vel, augue. Vestibulum ante ipsum primis in faucibus orci luctus et ultrices posuere cubilia Curae; Donec pharetra, magna vestibulum aliquet ultrices, erat tortor sollicitudin mi, sit amet lobortis sapien sapien non mi. Integer ac neque.",52,9805,43,6.1,9141,2352,6789
324,"Fair Game",2001,"https://www.youtube.com/embed/qSs5zsGoqs4","https://encrypted-tbn0.gstatic.com/images?q=tbn:ANd9GcQ4tG7BC0SE2SNUji4NBAmTKKl13L-IuMZpkiEbQm0YeWk9Z1SQUg",56,5.7,6662,627,6035,"In quis justo. Maecenas rhoncus aliquam lacus. Morbi quis tortor id nulla ultrices aliquet.",58,4799,6,3.9,6072,2596,3476
325,"Lust for Gold",1997,"https://www.youtube.com/embed/h-k0-Z9b4Cw","https://encrypted-tbn0.gstatic.com/images?q=tbn:ANd9GcS0uoN_00qCw12_q1GgGAdcbA-6sp6JzFguYZMxLObI8Ydh9OBk",28,8.4,9899,5209,4690,"Nam ultrices, libero non mattis pulvinar, nulla pede ullamcorper augue, a suscipit nulla elit ac nulla. Sed vel enim sit amet nunc viverra dapibus. Nulla suscipit ligula in lacus.",98,510,69,6.8,5943,1733,4210
326,"Dorado, El",1986,"https://www.youtube.com/embed/78ozCL4sQoI","https://encrypted-tbn0.gstatic.com/images?q=tbn:ANd9GcTiS27rf1ltLwxOAbTBhYvqJuvJG8ctIALtoknQh7MHlvV3r0UO",25,3.4,8301,2311,5990,"Suspendisse potenti. In eleifend quam a odio. In hac habitasse platea dictumst.",62,1379,55,3.6,7383,1733,5650
327,"Bill Cosby, Himself",2010,"https://www.youtube.com/embed/LcepHRTWI18","https://encrypted-tbn0.gstatic.com/images?q=tbn:ANd9GcTpzv6ZkKQ_5fFlx242_ZFGnV3MuzyUBrlVMhbcTFBKJGCr7XxS",57,7.2,1191,3539,-2348,"In hac habitasse platea dictumst. Etiam faucibus cursus urna. Ut tellus.",44,7612,56,9.1,8410,4860,3550
328,"Thunder Bay",2000,"https://www.youtube.com/embed/cENucEoMZic","https://encrypted-tbn0.gstatic.com/images?q=tbn:ANd9GcRqaaKELSsRKJh2pc05f1s5ksCTCIa-bgxbzGUm2T7leAI2nlTqZw",25,8.9,2733,5471,-2738,"Phasellus in felis. Donec semper sapien a libero. Nam dui.",30,4799,24,3.4,2016,2999,-983
329,"The Poseidon Adventure",2004,"https://www.youtube.com/embed/Sw_5YPAf7Zs","https://encrypted-tbn0.gstatic.com/images?q=tbn:ANd9GcTZmxe1lfZxGWCEdh5BIO8o0IWoInXoMB0QURL9yFrayrcsRK7J",26,1.8,6662,1865,4797,"Proin eu mi. Nulla ac enim. In tempor, turpis nec euismod scelerisque, quam turpis adipiscing lorem, vitae mattis nibh ligula nec sem.",80,9683,28,6.8,2034,6366,-4332
330,"Another Woman",1986,"https://www.youtube.com/embed/iW3t_wUDG5U","https://encrypted-tbn0.gstatic.com/images?q=tbn:ANd9GcS0uoN_00qCw12_q1GgGAdcbA-6sp6JzFguYZMxLObI8Ydh9OBk",94,3.6,3801,54,3747,"Maecenas ut massa quis augue luctus tincidunt. Nulla mollis molestie lorem. Quisque ut erat.",30,4828,31,8.9,118,213,-95
331,"Clifford",2012,"https://www.youtube.com/embed/9g-j4wuEOPo","https://encrypted-tbn0.gstatic.com/images?q=tbn:ANd9GcTZlJW6ILTHoyypnMTvpWTFl3IhTXHYM5kQntofSVvdKEozMRsTxQ",34,2.9,6774,2999,3775,"Donec diam neque, vestibulum eget, vulputate ut, ultrices vel, augue. Vestibulum ante ipsum primis in faucibus orci luctus et ultrices posuere cubilia Curae; Donec pharetra, magna vestibulum aliquet ultrices, erat tortor sollicitudin mi, sit amet lobortis sapien sapien non mi. Integer ac neque.",70,8567,28,7.5,198,1733,-1535
332,"Sky Fighters (Les Chevaliers Du Ciel)",2006,"https://www.youtube.com/embed/4AEkzL2SvmI","https://encrypted-tbn0.gstatic.com/images?q=tbn:ANd9GcR203qZ3CqJHkReGO_urfLpOmRqqwbZ6g8ZOVV-2aZbySbWl_abdg",66,1.8,6801,8964,-2163,"Phasellus in felis. Donec semper sapien a libero. Nam dui.",52,8546,81,3.4,6662,1214,5448
333,"The Big Trail",1997,"https://www.youtube.com/embed/8oTXc5t35Ro","https://encrypted-tbn0.gstatic.com/images?q=tbn:ANd9GcTZlJW6ILTHoyypnMTvpWTFl3IhTXHYM5kQntofSVvdKEozMRsTxQ",48,6.7,9696,213,9483,"Proin leo odio, porttitor id, consequat in, consequat ut, nulla. Sed accumsan felis. Ut at dolor quis odio consequat varius.",64,607,56,6.9,2987,9584,-6597
334,"The Poseidon Adventure",2012,"https://www.youtube.com/embed/oP-fRX_gB6o","https://encrypted-tbn0.gstatic.com/images?q=tbn:ANd9GcQzrbGfcJ8GKN78hn-r1fcQf4zH81e0MlsuOddkBJvhC5RvfF2DNw",19,8.1,6662,2443,4219,"Cras mi pede, malesuada in, imperdiet et, commodo vulputate, justo. In blandit ultrices enim. Lorem ipsum dolor sit amet, consectetuer adipiscing elit.",48,2435,56,1,2847,213,2634
335,"People Will Talk",1979,"https://www.youtube.com/embed/2FbDY0MeJf8","https://encrypted-tbn0.gstatic.com/images?q=tbn:ANd9GcR203qZ3CqJHkReGO_urfLpOmRqqwbZ6g8ZOVV-2aZbySbWl_abdg",33,1.8,12,1575,-1563,"Cras mi pede, malesuada in, imperdiet et, commodo vulputate, justo. In blandit ultrices enim. Lorem ipsum dolor sit amet, consectetuer adipiscing elit.",96,7438,3,3.2,7162,1865,5297
336,"Block-Heads",1985,"https://www.youtube.com/embed/78ozCL4sQoI","https://encrypted-tbn0.gstatic.com/images?q=tbn:ANd9GcSC_qEbYtBeELogQVPTeiWNRbcOXlYKbMYmMPaG67T_yrWKEiTV",42,6.7,8388,1061,7327,"Praesent id massa id nisl venenatis lacinia. Aenean sit amet justo. Morbi ut odio.",50,510,89,1.8,6774,2711,4063
337,"7 Women (a.k.a. Seven Women)",2006,"https://www.youtube.com/embed/iOMxsy8S7hk","https://encrypted-tbn0.gstatic.com/images?q=tbn:ANd9GcTrBuPeRIXbqvHjWMwFg1aZvVkw71rsNVla5A067w7kiY-DPB7N",20,5.9,6734,73,6661,"Praesent blandit. Nam nulla. Integer pede justo, lacinia eget, tincidunt eget, tempus vel, pede.",28,1836,95,3.4,12,3539,-3527
338,"Little Giants",1985,"https://www.youtube.com/embed/VUEaDUyeTR8","https://encrypted-tbn0.gstatic.com/images?q=tbn:ANd9GcTVx6QbLHPUKkVSj1TkaOANhnRfjtIXHhKnHSaIR2y3RkCgry-X",64,1.8,698,1865,-1167,"Proin leo odio, porttitor id, consequat in, consequat ut, nulla. Sed accumsan felis. Ut at dolor quis odio consequat varius.",70,6113,35,1,6469,627,5842
339,"Hype!",2002,"https://www.youtube.com/embed/7C2Nad0aMPg","https://encrypted-tbn0.gstatic.com/images?q=tbn:ANd9GcTTLFfQrJmhvXjL4d_udm6Z89QYglVi4hTEmbaDRdDoqHQsaQVg",95,9.3,8429,361,8068,"Duis aliquam convallis nunc. Proin at turpis a pede posuere nonummy. Integer non velit.",88,3074,50,8.5,118,156,-38
340,"The Pit, the Pendulum and Hope",2004,"https://www.youtube.com/embed/iOMxsy8S7hk","https://encrypted-tbn0.gstatic.com/images?q=tbn:ANd9GcQ1aky5NsvfU2oObNVwH5j9ZHJNNcxRkRhHEYTh8yhtqNLPmxk0lA",40,9.6,8410,1560,6850,"Curabitur in libero ut massa volutpat convallis. Morbi odio odio, elementum eu, interdum eu, tincidunt in, leo. Maecenas pulvinar lobortis est.",60,8135,2,4.7,9416,6554,2862
341,"Fair Game",1994,"https://www.youtube.com/embed/oNTzFnMXT3E","https://encrypted-tbn0.gstatic.com/images?q=tbn:ANd9GcRqaaKELSsRKJh2pc05f1s5ksCTCIa-bgxbzGUm2T7leAI2nlTqZw",81,5.7,8382,4196,4186,"Integer tincidunt ante vel ipsum. Praesent blandit lacinia erat. Vestibulum sed magna at nunc commodo placerat.",50,735,42,7.5,4286,4196,90
342,"Clifford",2011,"https://www.youtube.com/embed/4AEkzL2SvmI","https://encrypted-tbn0.gstatic.com/images?q=tbn:ANd9GcQ3liTMd9u-FOh16V1KslqpsRMQ7s9_8wAeiIkai8222SoHyIRe",35,1.1,9496,7462,2034,"In congue. Etiam justo. Etiam pretium iaculis justo.",28,7612,41,1.1,3417,1545,1872
343,"The Living Magoroku",1994,"https://www.youtube.com/embed/Xwzwmc2AZYg","https://encrypted-tbn0.gstatic.com/images?q=tbn:ANd9GcTsjOFvygMO8x-qvjqCJz2LIuSNcJ3SwoL3PgjTz-9CZFQxNyzGng",42,4.3,5704,3428,2276,"Praesent blandit. Nam nulla. Integer pede justo, lacinia eget, tincidunt eget, tempus vel, pede.",30,2866,7,3.8,2269,2965,-696
344,"People Will Talk",1999,"https://www.youtube.com/embed/_aHDqS8EMn0","https://i.pinimg.com/236x/3b/29/73/3b2973cc00e87a821ad68647747259be--pattern-texture-paints.jpg",82,1.5,6006,2617,3389,"In quis justo. Maecenas rhoncus aliquam lacus. Morbi quis tortor id nulla ultrices aliquet.",48,8647,70,8.5,7576,305,7271
345,"Protector (Protektor)",2010,"https://www.youtube.com/embed/3svtRyLq3b0","https://encrypted-tbn0.gstatic.com/images?q=tbn:ANd9GcTiS27rf1ltLwxOAbTBhYvqJuvJG8ctIALtoknQh7MHlvV3r0UO",61,1.2,9585,5206,4379,"Proin eu mi. Nulla ac enim. In tempor, turpis nec euismod scelerisque, quam turpis adipiscing lorem, vitae mattis nibh ligula nec sem.",52,7121,4,4.3,8816,2617,6199
346,"Digging Up the Marrow",2002,"https://www.youtube.com/embed/mAX1oGLvMAA","https://encrypted-tbn0.gstatic.com/images?q=tbn:ANd9GcTZmxe1lfZxGWCEdh5BIO8o0IWoInXoMB0QURL9yFrayrcsRK7J",48,6.9,2323,3607,-1284,"Quisque id justo sit amet sapien dignissim vestibulum. Vestibulum ante ipsum primis in faucibus orci luctus et ultrices posuere cubilia Curae; Nulla dapibus dolor vel est. Donec odio justo, sollicitudin ut, suscipit a, feugiat et, eros.",76,3119,65,6.8,5943,3527,2416
347,"Bullet",1996,"https://www.youtube.com/embed/REXXOGV1IIE","https://encrypted-tbn0.gstatic.com/images?q=tbn:ANd9GcTZmxe1lfZxGWCEdh5BIO8o0IWoInXoMB0QURL9yFrayrcsRK7J",20,3.6,6072,4,6068,"Proin eu mi. Nulla ac enim. In tempor, turpis nec euismod scelerisque, quam turpis adipiscing lorem, vitae mattis nibh ligula nec sem.",76,7481,26,3.4,2733,831,1902
348,"AVPR: Aliens vs. Predator - Requiem",2007,"https://www.youtube.com/embed/ee1172yeqyE","https://encrypted-tbn0.gstatic.com/images?q=tbn:ANd9GcRZ2qgbwUkZMB6Z3KUBla8OIzYNOBzMaNpoAeNofRYZj8V27vwD",36,5.7,2733,573,2160,"Curabitur in libero ut massa volutpat convallis. Morbi odio odio, elementum eu, interdum eu, tincidunt in, leo. Maecenas pulvinar lobortis est.",70,7438,61,2,6199,285,5914
349,"Fair Game",2010,"https://www.youtube.com/embed/qSs5zsGoqs4","https://encrypted-tbn0.gstatic.com/images?q=tbn:ANd9GcSOWY9FWNsfX_XrmFypiMILLGG-QtrQcxL8f5w3qsIiNjiSdC3x",69,3.2,4602,7462,-2860,"Quisque porta volutpat erat. Quisque erat eros, viverra eget, congue eget, semper rutrum, nulla. Nunc purus.",38,3455,84,4.8,5146,9584,-4438
350,"The Innocent",2002,"https://www.youtube.com/embed/2BoyDp49C6Y","https://encrypted-tbn0.gstatic.com/images?q=tbn:ANd9GcTsjOFvygMO8x-qvjqCJz2LIuSNcJ3SwoL3PgjTz-9CZFQxNyzGng",36,7,8429,3607,4822,"Maecenas leo odio, condimentum id, luctus nec, molestie sed, justo. Pellentesque viverra pede ac diam. Cras pellentesque volutpat dui.",62,9683,35,2,5696,1575,4121
351,"Tis kakomoiras",2012,"https://www.youtube.com/embed/iW3t_wUDG5U","https://encrypted-tbn0.gstatic.com/images?q=tbn:ANd9GcSC_qEbYtBeELogQVPTeiWNRbcOXlYKbMYmMPaG67T_yrWKEiTV",96,9.5,9822,3539,6283,"Cum sociis natoque penatibus et magnis dis parturient montes, nascetur ridiculus mus. Vivamus vestibulum sagittis sapien. Cum sociis natoque penatibus et magnis dis parturient montes, nascetur ridiculus mus.",50,2476,7,4.1,6469,2311,4158
352,"Meet the Fockers",1999,"https://www.youtube.com/embed/LO9I2fpyUyg","https://i.pinimg.com/236x/5f/f6/69/5ff6693c3694f55e8ed9738084c4c6b1--d-design-design-concepts.jpg",98,8.9,6801,3371,3430,"Sed ante. Vivamus tortor. Duis mattis egestas metus.",70,8485,6,1.5,9141,3421,5720
353,"Gunday",2006,"https://www.youtube.com/embed/YVYzxm_RqMg","https://encrypted-tbn0.gstatic.com/images?q=tbn:ANd9GcTZmxe1lfZxGWCEdh5BIO8o0IWoInXoMB0QURL9yFrayrcsRK7J",75,6.2,2016,7659,-5643,"Curabitur in libero ut massa volutpat convallis. Morbi odio odio, elementum eu, interdum eu, tincidunt in, leo. Maecenas pulvinar lobortis est.",70,5941,31,9.6,2847,3118,-271
354,"Condorman",1985,"https://www.youtube.com/embed/RaA9elSYnpQ","https://encrypted-tbn0.gstatic.com/images?q=tbn:ANd9GcR203qZ3CqJHkReGO_urfLpOmRqqwbZ6g8ZOVV-2aZbySbWl_abdg",37,3.2,7383,772,6611,"Curabitur at ipsum ac tellus semper interdum. Mauris ullamcorper purus sit amet nulla. Quisque arcu libero, rutrum ac, lobortis vel, dapibus at, diam.",26,6868,31,1.2,6072,7462,-1390
355,"The Land Before Time XII: The Great Day of the Flyers",2011,"https://www.youtube.com/embed/IU3xV9ZRYlk","https://encrypted-tbn0.gstatic.com/images?q=tbn:ANd9GcT8fsnqcp8Y3Y2dxkM4H8TJyS7bRYttijiNFZ-mruoqpzO29uM7",65,1.2,8496,73,8423,"Praesent id massa id nisl venenatis lacinia. Aenean sit amet justo. Morbi ut odio.",48,1277,98,2.8,3411,54,3357
356,"Dragon Ball Z the Movie: The World's Strongest (a.k.a. Dragon Ball Z: The Strongest Guy in The World) (Doragon bôru Z: Kono yo de ichiban tsuyoi yatsu)",2011,"https://www.youtube.com/embed/3svtRyLq3b0","https://encrypted-tbn0.gstatic.com/images?q=tbn:ANd9GcTjDxlkO4SurlCq11A009Vm2yOW0XT4x5GHflg-pkVrTiqWURnydg",77,9.5,1191,5515,-4324,"Maecenas tristique, est et tempus semper, est quam pharetra magna, ac consequat metus sapien ut nunc. Vestibulum ante ipsum primis in faucibus orci luctus et ultrices posuere cubilia Curae; Mauris viverra diam vitae quam. Suspendisse potenti.",84,2840,34,8.9,5704,1374,4330
357,"Thunder Bay",2000,"https://www.youtube.com/embed/IU3xV9ZRYlk","https://encrypted-tbn0.gstatic.com/images?q=tbn:ANd9GcSZ6r6rDjMvQsp22jqT0ZPe_z-oKhAWQcjwgB5egzck4lqzLHYHCg",96,4.8,7256,5209,2047,"Curabitur in libero ut massa volutpat convallis. Morbi odio odio, elementum eu, interdum eu, tincidunt in, leo. Maecenas pulvinar lobortis est.",38,8056,62,2.8,8382,5471,2911
358,"The Last Seduction",1992,"https://www.youtube.com/embed/Bn9iowpSWRs","https://encrypted-tbn0.gstatic.com/images?q=tbn:ANd9GcTohJTJK1v5tSnhy3g7gvaali5Xq0Qq6MwRJMGVD5enka23vy2H",64,7.8,9683,1374,8309,"Proin leo odio, porttitor id, consequat in, consequat ut, nulla. Sed accumsan felis. Ut at dolor quis odio consequat varius.",90,8838,44,6.3,3458,3118,340
359,"Bullet",2004,"https://www.youtube.com/embed/-6jCNhebfg8","https://i.pinimg.com/236x/5f/f6/69/5ff6693c3694f55e8ed9738084c4c6b1--d-design-design-concepts.jpg",98,7.7,6579,1374,5205,"Quisque porta volutpat erat. Quisque erat eros, viverra eget, congue eget, semper rutrum, nulla. Nunc purus.",40,2413,89,1.1,9994,4125,5869
360,"The Long Voyage Home",2011,"https://www.youtube.com/embed/6W0KFTj50zI","https://encrypted-tbn0.gstatic.com/images?q=tbn:ANd9GcRUlnvuLTJg0mT65nGxwZY6OfVvev6DxlvShy5w5Mpai-i6Vk6Qfg",70,8.5,1191,2240,-1049,"Suspendisse potenti. In eleifend quam a odio. In hac habitasse platea dictumst.",38,4799,4,7.2,8611,6892,1719
361,"Poolboy: Drowning Out the Fury",2005,"https://www.youtube.com/embed/9g-j4wuEOPo","https://encrypted-tbn0.gstatic.com/images?q=tbn:ANd9GcTZmxe1lfZxGWCEdh5BIO8o0IWoInXoMB0QURL9yFrayrcsRK7J",17,5.7,5954,3421,2533,"Morbi non lectus. Aliquam sit amet diam in magna bibendum imperdiet. Nullam orci pede, venenatis non, sodales sed, tincidunt eu, felis.",26,607,70,6,7393,781,6612
362,"Hype!",2011,"https://www.youtube.com/embed/fnLjm_yL7vE","https://encrypted-tbn0.gstatic.com/images?q=tbn:ANd9GcS5gl0DLTFbt7bYHEmtfUaWEKVmT1jfD8Td6ILXO_YOKSFekX9e",22,8.3,132,781,-649,"Proin leo odio, porttitor id, consequat in, consequat ut, nulla. Sed accumsan felis. Ut at dolor quis odio consequat varius.",90,4799,62,6,3458,3313,145
363,"Another Woman",2011,"https://www.youtube.com/embed/6W0KFTj50zI","https://encrypted-tbn0.gstatic.com/images?q=tbn:ANd9GcRJqLpbXoWWpbGuNXVAuF8Iy2X8EFCKx-z2jPdj5XGEL_wrFgzY",96,4.9,2795,4196,-1401,"Lorem ipsum dolor sit amet, consectetuer adipiscing elit. Proin risus. Praesent lectus.",100,1636,3,6.7,9496,7659,1837
364,"Hardcore",1989,"https://www.youtube.com/embed/eqDHqOcXjRQ","https://encrypted-tbn0.gstatic.com/images?q=tbn:ANd9GcSYy4S-T_nbr708KkpYcV-RgmyX_MPtCXzFVr44X7S9CAQsyQAE3Q",60,2.4,1360,3527,-2167,"Sed ante. Vivamus tortor. Duis mattis egestas metus.",76,5941,34,6.8,8429,6892,1537
365,"Harry Potter and the Order of the Phoenix",2008,"https://www.youtube.com/embed/RyYFAqJFYdE","https://encrypted-tbn0.gstatic.com/images?q=tbn:ANd9GcToWUNrpDN1sKiQrTBrAPVZaaHkjYWkdwsMh5Igburh2w20IPRs",98,7.7,2847,562,2285,"Aliquam quis turpis eget elit sodales scelerisque. Mauris sit amet eros. Suspendisse accumsan tortor quis turpis.",80,2840,26,5.1,9090,8629,461
366,"Murder Ahoy",1999,"https://www.youtube.com/embed/ee12SvnnrSw","https://encrypted-tbn0.gstatic.com/images?q=tbn:ANd9GcQ1aky5NsvfU2oObNVwH5j9ZHJNNcxRkRhHEYTh8yhtqNLPmxk0lA",95,4.8,2777,2606,171,"Phasellus sit amet erat. Nulla tempus. Vivamus in felis eu sapien cursus vestibulum.",26,4526,45,9.3,9496,3428,6068
367,"Coming Down the Mountain",1977,"https://www.youtube.com/embed/oNTzFnMXT3E","https://encrypted-tbn0.gstatic.com/images?q=tbn:ANd9GcSaZZLwGXqiNU5rkhexU86wKZGzymZWTp2nKRDFdITh7rD7Jb6yGA",68,5.7,6006,8629,-2623,"In sagittis dui vel nisl. Duis ac nibh. Fusce lacus purus, aliquet at, feugiat non, pretium quis, lectus.",56,8851,23,3.1,8301,2617,5684
368,"Iceberg, L'",2009,"https://www.youtube.com/embed/LcepHRTWI18","https://encrypted-tbn0.gstatic.com/images?q=tbn:ANd9GcTohJTJK1v5tSnhy3g7gvaali5Xq0Qq6MwRJMGVD5enka23vy2H",94,8.4,5541,6427,-886,"Aliquam quis turpis eget elit sodales scelerisque. Mauris sit amet eros. Suspendisse accumsan tortor quis turpis.",68,8567,4,9.6,2016,5209,-3193
369,"Jin Roh: The Wolf Brigade (Jin-Rô)",2007,"https://www.youtube.com/embed/iW3t_wUDG5U","https://encrypted-tbn0.gstatic.com/images?q=tbn:ANd9GcTZlJW6ILTHoyypnMTvpWTFl3IhTXHYM5kQntofSVvdKEozMRsTxQ",3,2,8301,2198,6103,"Integer ac leo. Pellentesque ultrices mattis odio. Donec vitae nisi.",96,2682,30,5.7,2733,1560,1173
370,"Fair Game",2004,"https://www.youtube.com/embed/zCecE7OyVMU","https://encrypted-tbn0.gstatic.com/images?q=tbn:ANd9GcQ4tG7BC0SE2SNUji4NBAmTKKl13L-IuMZpkiEbQm0YeWk9Z1SQUg",3,4.1,3411,879,2532,"Duis bibendum. Morbi non quam nec dui luctus rutrum. Nulla tellus.",82,3441,70,3.2,2779,2308,471
371,"Murder Ahoy",2002,"https://www.youtube.com/embed/iM8kaNCrnX0","https://encrypted-tbn0.gstatic.com/images?q=tbn:ANd9GcRauFfIne8mHbF9MCn-LxY8C6gHqalPefcj6s8z0B9JZwEnD5A4",68,9.3,4108,225,3883,"Nulla ut erat id mauris vulputate elementum. Nullam varius. Nulla facilisi.",26,1528,60,6,2016,3371,-1355
372,"Iceberg, L'",1997,"https://www.youtube.com/embed/HwWWws3kzKg","https://encrypted-tbn0.gstatic.com/images?q=tbn:ANd9GcSJJAS-aY5yM_o538SFwYJKMI1ICZvCAEdnVZX59tINRulVx7aBpA",31,4.3,7393,8004,-611,"Donec diam neque, vestibulum eget, vulputate ut, ultrices vel, augue. Vestibulum ante ipsum primis in faucibus orci luctus et ultrices posuere cubilia Curae; Donec pharetra, magna vestibulum aliquet ultrices, erat tortor sollicitudin mi, sit amet lobortis sapien sapien non mi. Integer ac neque.",30,2476,77,8.9,4286,4196,90
373,"Diary of a Shinjuku Thief (Shinjuku dorobo nikki)",1998,"https://www.youtube.com/embed/iW3t_wUDG5U","https://encrypted-tbn0.gstatic.com/images?q=tbn:ANd9GcQ06LkOABmCBkCQO4wr6V0tHNUOyUYNR-YLaEHAblZo1ZqlooBmOg",42,5.7,3530,4712,-1182,"Phasellus sit amet erat. Nulla tempus. Vivamus in felis eu sapien cursus vestibulum.",38,7481,37,3.4,7900,8629,-729
374,"Transylvania",1993,"https://www.youtube.com/embed/MaI-4NepPfU","https://encrypted-tbn0.gstatic.com/images?q=tbn:ANd9GcSQ-QvEfMwKoUuWLDF2x2M1V4BTEN6-uoYrr8ShYvdSVQcHru6h",62,2.4,4108,4020,88,"Nulla ut erat id mauris vulputate elementum. Nullam varius. Nulla facilisi.",86,607,26,3.2,7762,4,7758
375,"Barabbas",2005,"https://www.youtube.com/embed/ocWpGdITSR4","https://encrypted-tbn0.gstatic.com/images?q=tbn:ANd9GcSBKrAU7qHXZ_vqij5HmW3xvTgSZ9qA7lT4fxAsUEXHGvWHHXai",4,2.1,2323,1865,458,"Quisque porta volutpat erat. Quisque erat eros, viverra eget, congue eget, semper rutrum, nulla. Nunc purus.",96,2476,98,1.4,2409,3371,-962
376,"Bill Cosby, Himself",2012,"https://www.youtube.com/embed/ka3J1sUhQ4M","https://images-na.ssl-images-amazon.com/images/I/41SFojuU1FL._SY600_.jpg",90,3.9,5696,2999,2697,"Lorem ipsum dolor sit amet, consectetuer adipiscing elit. Proin risus. Praesent lectus.",86,2840,43,7,6734,1061,5673
377,"Thoroughly Modern Millie",2002,"https://www.youtube.com/embed/QJlh0IPQbbo","https://encrypted-tbn0.gstatic.com/images?q=tbn:ANd9GcSfenuQRjGbddBAE4j3I_GN73Ch-EI9uairOfxWWbLQYAluLoDWCQ",77,3.2,8446,2198,6248,"Nulla ut erat id mauris vulputate elementum. Nullam varius. Nulla facilisi.",86,6777,55,5.1,8611,305,8306
378,"Alive",2009,"https://www.youtube.com/embed/G9T_f7DjYho","https://encrypted-tbn0.gstatic.com/images?q=tbn:ANd9GcQ06LkOABmCBkCQO4wr6V0tHNUOyUYNR-YLaEHAblZo1ZqlooBmOg",89,7,8377,2352,6025,"Donec diam neque, vestibulum eget, vulputate ut, ultrices vel, augue. Vestibulum ante ipsum primis in faucibus orci luctus et ultrices posuere cubilia Curae; Donec pharetra, magna vestibulum aliquet ultrices, erat tortor sollicitudin mi, sit amet lobortis sapien sapien non mi. Integer ac neque.",66,3444,56,1.8,2987,3371,-384
379,"Gunday",2010,"https://www.youtube.com/embed/VUEaDUyeTR8","https://encrypted-tbn0.gstatic.com/images?q=tbn:ANd9GcR6OdK3cVIVUn07PmO7zFQb1JyTfdi6L4FwxFWOD9dfwTwN4hEt",95,5.1,2733,7219,-4486,"Morbi non lectus. Aliquam sit amet diam in magna bibendum imperdiet. Nullam orci pede, venenatis non, sodales sed, tincidunt eu, felis.",28,25,17,2.4,8388,4860,3528
380,"Bullet",2005,"https://www.youtube.com/embed/KbZ3TVEkuDY","https://encrypted-tbn0.gstatic.com/images?q=tbn:ANd9GcQ_K_OlRU89USb4Vi53WsTFwqiEXKhfRUVw08lWTiH5XSmSISDDwg",70,2.1,2779,156,2623,"Morbi non lectus. Aliquam sit amet diam in magna bibendum imperdiet. Nullam orci pede, venenatis non, sodales sed, tincidunt eu, felis.",44,25,42,8.9,4108,5471,-1363
381,"People Will Talk",1988,"https://www.youtube.com/embed/dfUJm6XgD7g","https://encrypted-tbn0.gstatic.com/images?q=tbn:ANd9GcTVx6QbLHPUKkVSj1TkaOANhnRfjtIXHhKnHSaIR2y3RkCgry-X",65,7.8,9141,7462,1679,"Integer ac leo. Pellentesque ultrices mattis odio. Donec vitae nisi.",100,9382,19,8.3,6006,1545,4461
382,"The Sword of Doom",1989,"https://www.youtube.com/embed/7C2Nad0aMPg","https://encrypted-tbn0.gstatic.com/images?q=tbn:ANd9GcSQ-QvEfMwKoUuWLDF2x2M1V4BTEN6-uoYrr8ShYvdSVQcHru6h",64,3.4,1555,5515,-3960,"Quisque porta volutpat erat. Quisque erat eros, viverra eget, congue eget, semper rutrum, nulla. Nunc purus.",98,8065,95,3.1,8301,1865,6436
383,"Fido",1988,"https://www.youtube.com/embed/6SO96lvWqzc","https://encrypted-tbn0.gstatic.com/images?q=tbn:ANd9GcRqaaKELSsRKJh2pc05f1s5ksCTCIa-bgxbzGUm2T7leAI2nlTqZw",61,4.9,2779,3881,-1102,"Fusce consequat. Nulla nisl. Nunc nisl.",26,3441,17,3.2,2016,7659,-5643
384,"AVPR: Aliens vs. Predator - Requiem",2003,"https://www.youtube.com/embed/Xwzwmc2AZYg","https://encrypted-tbn0.gstatic.com/images?q=tbn:ANd9GcQ3liTMd9u-FOh16V1KslqpsRMQ7s9_8wAeiIkai8222SoHyIRe",4,7.7,3923,3771,152,"Mauris enim leo, rhoncus sed, vestibulum sit amet, cursus id, turpis. Integer aliquet, massa id lobortis convallis, tortor risus dapibus augue, vel accumsan tellus nisi eu orci. Mauris lacinia sapien quis libero.",62,510,36,2.4,4324,2001,2323
385,"Vicky Donor",1999,"https://www.youtube.com/embed/BQcvHEkGaEA","https://encrypted-tbn0.gstatic.com/images?q=tbn:ANd9GcTjDxlkO4SurlCq11A009Vm2yOW0XT4x5GHflg-pkVrTiqWURnydg",82,9.1,9696,2711,6985,"Sed sagittis. Nam congue, risus semper porta volutpat, quam pede lobortis ligula, sit amet eleifend pede libero quis orci. Nullam molestie nibh in lectus.",56,1948,24,2.4,8382,4860,3522
386,"The Wrong Move",2011,"https://www.youtube.com/embed/6Ui6m_eEEOI","https://encrypted-tbn0.gstatic.com/images?q=tbn:ANd9GcS5gl0DLTFbt7bYHEmtfUaWEKVmT1jfD8Td6ILXO_YOKSFekX9e",77,8.4,3458,1496,1962,"Proin eu mi. Nulla ac enim. In tempor, turpis nec euismod scelerisque, quam turpis adipiscing lorem, vitae mattis nibh ligula nec sem.",38,5941,61,4.2,5498,1898,3600
387,"Quand je serai petit",1997,"https://www.youtube.com/embed/ka3J1sUhQ4M","https://encrypted-tbn0.gstatic.com/images?q=tbn:ANd9GcTt-58zOD-K4oKQ0AbvYduMdi-NxFRYLjx9Maf9ECQJMZkvfanqUw",35,1,3417,3251,166,"Morbi non lectus. Aliquam sit amet diam in magna bibendum imperdiet. Nullam orci pede, venenatis non, sodales sed, tincidunt eu, felis.",64,4907,81,3.2,3530,1865,1665
388,"American Pie Presents The Naked Mile (American Pie 5: The Naked Mile)",1994,"https://www.youtube.com/embed/eqDHqOcXjRQ","https://encrypted-tbn0.gstatic.com/images?q=tbn:ANd9GcSkjHflFbGJwA3Dk6FW71ynZ5C6z_y9dkcX7Q0Q-2NSkRIUerlH",2,6.7,5529,2240,3289,"Morbi non lectus. Aliquam sit amet diam in magna bibendum imperdiet. Nullam orci pede, venenatis non, sodales sed, tincidunt eu, felis.",38,3074,29,8.5,118,3412,-3294
389,"Bird of Paradise",1992,"https://www.youtube.com/embed/COTt1zvBUJk","https://encrypted-tbn0.gstatic.com/images?q=tbn:ANd9GcQN3_I47i-MkaTBmK9e2PzNkhGoJsWeB5U_dn5cat3hDSHLCPjU",20,8.4,9389,1592,7797,"In congue. Etiam justo. Etiam pretium iaculis justo.",82,8567,66,6.9,5541,3428,2113
390,"Miami Vice",1998,"https://www.youtube.com/embed/iOMxsy8S7hk","https://encrypted-tbn0.gstatic.com/images?q=tbn:ANd9GcQ_K_OlRU89USb4Vi53WsTFwqiEXKhfRUVw08lWTiH5XSmSISDDwg",81,4.6,1795,781,1014,"Morbi porttitor lorem id ligula. Suspendisse ornare consequat lectus. In est risus, auctor sed, tristique in, tempus sit amet, sem.",26,1589,34,4.1,2034,6554,-4520
391,"Azumi 2: Death or Love",1997,"https://www.youtube.com/embed/nMVDQZ34joY","https://i.pinimg.com/736x/37/a0/99/37a099570abb65e478268af396315658--brochure-design-colour-combinations.jpg",31,4.3,9090,2606,6484,"Mauris enim leo, rhoncus sed, vestibulum sit amet, cursus id, turpis. Integer aliquet, massa id lobortis convallis, tortor risus dapibus augue, vel accumsan tellus nisi eu orci. Mauris lacinia sapien quis libero.",58,1948,56,5.1,6801,2311,4490
392,"Confidence",2012,"https://www.youtube.com/embed/iW3t_wUDG5U","https://encrypted-tbn0.gstatic.com/images?q=tbn:ANd9GcQInYhbERWHKRlaq1eJAqZqaGQ9zndtpCyGofdPFToPGHuZUGCS",31,5.1,9090,6554,2536,"Nulla ut erat id mauris vulputate elementum. Nullam varius. Nulla facilisi.",86,3455,3,7,8388,156,8232
393,"Level Five",1997,"https://www.youtube.com/embed/78ozCL4sQoI","https://encrypted-tbn0.gstatic.com/images?q=tbn:ANd9GcRxLYJSuzc9AAuuJ3R1HulbKM_T8_whdwPZQj7VyYonHOME6fYq",90,7.7,284,361,-77,"Pellentesque at nulla. Suspendisse potenti. Cras in purus eu magna vulputate luctus.",64,7690,40,6.3,8429,5206,3223
394,"Breaking the Silence: Truth and Lies in the War on Terror",2007,"https://www.youtube.com/embed/DyQ8PoBV_Vo","https://encrypted-tbn0.gstatic.com/images?q=tbn:ANd9GcRZ2qgbwUkZMB6Z3KUBla8OIzYNOBzMaNpoAeNofRYZj8V27vwD",3,9.7,284,8964,-8680,"Fusce posuere felis sed lacus. Morbi sem mauris, laoreet ut, rhoncus aliquet, pulvinar sed, nisl. Nunc rhoncus dui vel sem.",60,4828,17,3.1,9696,9584,112
395,"The Story of Xinghua",2000,"https://www.youtube.com/embed/zCecE7OyVMU","https://i.pinimg.com/236x/3b/29/73/3b2973cc00e87a821ad68647747259be--pattern-texture-paints.jpg",6,1.8,692,54,638,"Praesent blandit. Nam nulla. Integer pede justo, lacinia eget, tincidunt eget, tempus vel, pede.",38,9178,49,4.1,6275,1061,5214
396,"Wing and a Prayer",2002,"https://www.youtube.com/embed/i6ilL5z6cjA","https://encrypted-tbn0.gstatic.com/images?q=tbn:ANd9GcTVx6QbLHPUKkVSj1TkaOANhnRfjtIXHhKnHSaIR2y3RkCgry-X",98,4.1,9696,1545,8151,"Vestibulum ac est lacinia nisi venenatis tristique. Fusce congue, diam id ornare imperdiet, sapien urna pretium nisl, ut volutpat sapien arcu sed augue. Aliquam erat volutpat.",48,1836,9,3.8,1360,1025,335
397,"Little Nikita",2011,"https://www.youtube.com/embed/8W6yYBAUxv4","https://encrypted-tbn0.gstatic.com/images?q=tbn:ANd9GcTTLFfQrJmhvXjL4d_udm6Z89QYglVi4hTEmbaDRdDoqHQsaQVg",28,5.7,7683,1560,6123,"Proin eu mi. Nulla ac enim. In tempor, turpis nec euismod scelerisque, quam turpis adipiscing lorem, vitae mattis nibh ligula nec sem.",32,510,11,6,4108,573,3535
398,"Payday",2001,"https://www.youtube.com/embed/eqDHqOcXjRQ","https://encrypted-tbn0.gstatic.com/images?q=tbn:ANd9GcQj3o8UxHr9-tOcX5N5ppAE1Y9EZS5-9IYjKEogAzmsetJB5g0w",26,9.3,8437,562,7875,"Morbi non lectus. Aliquam sit amet diam in magna bibendum imperdiet. Nullam orci pede, venenatis non, sodales sed, tincidunt eu, felis.",40,8838,38,6.9,2987,1865,1122
399,"Escaflowne: The Movie (Escaflowne)",2012,"https://www.youtube.com/embed/nmGmu-knybU","https://encrypted-tbn0.gstatic.com/images?q=tbn:ANd9GcT4OdTRV0WhSYFs5jcy1IZYf9s7DjJToLKAVXlTv4GhzQcgmD-C",77,9.6,2016,923,1093,"Maecenas ut massa quis augue luctus tincidunt. Nulla mollis molestie lorem. Quisque ut erat.",70,4828,34,5.1,3923,573,3350
400,"Edmond",2011,"https://www.youtube.com/embed/6W0KFTj50zI","https://encrypted-tbn0.gstatic.com/images?q=tbn:ANd9GcTsjOFvygMO8x-qvjqCJz2LIuSNcJ3SwoL3PgjTz-9CZFQxNyzGng",35,4.2,9585,1590,7995,"Fusce consequat. Nulla nisl. Nunc nisl.",54,8065,35,1.1,6734,2308,4426
401,"Fido",1998,"https://www.youtube.com/embed/LO9I2fpyUyg","https://encrypted-tbn0.gstatic.com/images?q=tbn:ANd9GcTjDxlkO4SurlCq11A009Vm2yOW0XT4x5GHflg-pkVrTiqWURnydg",2,3.4,2779,285,2494,"Lorem ipsum dolor sit amet, consectetuer adipiscing elit. Proin risus. Praesent lectus.",64,6632,19,8.1,6175,3313,2862
402,"The King",2002,"https://www.youtube.com/embed/nMVDQZ34joY","https://encrypted-tbn0.gstatic.com/images?q=tbn:ANd9GcQ5LAO-oqK_jHF33R_asKWptHCRYc_456jcsgrngpU6q8htwl24",65,4.8,7383,6427,956,"Integer ac leo. Pellentesque ultrices mattis odio. Donec vitae nisi.",82,2866,35,5.8,8410,3371,5039
403,"Payday",1994,"https://www.youtube.com/embed/1roy4o4tqQM","https://encrypted-tbn0.gstatic.com/images?q=tbn:ANd9GcQ1aky5NsvfU2oObNVwH5j9ZHJNNcxRkRhHEYTh8yhtqNLPmxk0lA",9,7.7,8429,1496,6933,"Donec diam neque, vestibulum eget, vulputate ut, ultrices vel, augue. Vestibulum ante ipsum primis in faucibus orci luctus et ultrices posuere cubilia Curae; Donec pharetra, magna vestibulum aliquet ultrices, erat tortor sollicitudin mi, sit amet lobortis sapien sapien non mi. Integer ac neque.",36,3441,38,5.1,6869,3881,2988
404,"Zatoichi the Outlaw (Zatôichi rôyaburi) (Zatôichi 16)",1992,"https://www.youtube.com/embed/7Yz10uCVNVk","https://encrypted-tbn0.gstatic.com/images?q=tbn:ANd9GcQ1RC08Lpg31X2H7K5Uphlh7PGrzq7-JtVNzeSh-4UIh-JZbUaCDg",70,1.8,9683,1983,7700,"Pellentesque at nulla. Suspendisse potenti. Cras in purus eu magna vulputate luctus.",56,9164,80,1.7,698,1898,-1200
405,"When Time Ran Out...",2004,"https://www.youtube.com/embed/7C2Nad0aMPg","https://encrypted-tbn0.gstatic.com/images?q=tbn:ANd9GcQoGIgMrMpVA2TiWG8g9ENb7x-ZrciYB-gqzjyCnG-C2EgT8ePfkA",66,7,7715,1496,6219,"Nulla ut erat id mauris vulputate elementum. Nullam varius. Nulla facilisi.",56,1589,28,6.3,9141,2240,6901
406,"Bullet",2003,"https://www.youtube.com/embed/PdL8kn_G5EQ","https://encrypted-tbn0.gstatic.com/images?q=tbn:ANd9GcTjDxlkO4SurlCq11A009Vm2yOW0XT4x5GHflg-pkVrTiqWURnydg",98,8.4,6869,176,6693,"Fusce posuere felis sed lacus. Morbi sem mauris, laoreet ut, rhoncus aliquet, pulvinar sed, nisl. Nunc rhoncus dui vel sem.",22,735,65,6.7,5954,1590,4364
407,"Breaking the Silence: Truth and Lies in the War on Terror",2005,"https://www.youtube.com/embed/ocWpGdITSR4","https://encrypted-tbn0.gstatic.com/images?q=tbn:ANd9GcTpzv6ZkKQ_5fFlx242_ZFGnV3MuzyUBrlVMhbcTFBKJGCr7XxS",29,1.5,6774,1741,5033,"Donec diam neque, vestibulum eget, vulputate ut, ultrices vel, augue. Vestibulum ante ipsum primis in faucibus orci luctus et ultrices posuere cubilia Curae; Donec pharetra, magna vestibulum aliquet ultrices, erat tortor sollicitudin mi, sit amet lobortis sapien sapien non mi. Integer ac neque.",26,4907,2,1.5,8226,1733,6493
408,"Coming Down the Mountain",2003,"https://www.youtube.com/embed/7Yz10uCVNVk","https://encrypted-tbn0.gstatic.com/images?q=tbn:ANd9GcSflOt4SdSx3LCTNP7im_XpsqHeeK_V_ltLPZEnK4mLjl4Eja_t",34,1,8382,2240,6142,"Fusce posuere felis sed lacus. Morbi sem mauris, laoreet ut, rhoncus aliquet, pulvinar sed, nisl. Nunc rhoncus dui vel sem.",60,7690,26,8.9,1191,2443,-1252
409,"Murder Ahoy",1977,"https://www.youtube.com/embed/3_bUymlkSuA","https://encrypted-tbn0.gstatic.com/images?q=tbn:ANd9GcQX7g7WDTuGnT2syPcShrXK1gFJn4uMaACeAnWvesheIZXX58K1",22,1.8,6869,573,6296,"Praesent blandit. Nam nulla. Integer pede justo, lacinia eget, tincidunt eget, tempus vel, pede.",58,1620,43,3.2,8446,1898,6548
410,"American Pie Presents The Naked Mile (American Pie 5: The Naked Mile)",2006,"https://www.youtube.com/embed/QJlh0IPQbbo","https://encrypted-tbn0.gstatic.com/images?q=tbn:ANd9GcSRkE8RSex-89LA2Msfb1Vq6eH047lvDYppmp9IwK2zLgw2nbE-Uw",98,5.4,7890,4125,3765,"Maecenas leo odio, condimentum id, luctus nec, molestie sed, justo. Pellentesque viverra pede ac diam. Cras pellentesque volutpat dui.",22,7438,55,2.4,9822,1061,8761
411,"Dr. Jekyll and Ms. Hyde",2005,"https://www.youtube.com/embed/9gWsyEkKO1A","https://encrypted-tbn0.gstatic.com/images?q=tbn:ANd9GcRmeUcg7O8EkPtcOaGTwx1hvLuj5TbCPLmfq_zT0IhPpcbOWbBUDA",36,1.8,2269,1898,371,"Vestibulum quam sapien, varius ut, blandit non, interdum in, ante. Vestibulum ante ipsum primis in faucibus orci luctus et ultrices posuere cubilia Curae; Duis faucibus accumsan odio. Curabitur convallis.",28,8065,2,2.4,8816,3444,5372
412,"Clifford",2005,"https://www.youtube.com/embed/ee1172yeqyE","https://encrypted-tbn0.gstatic.com/images?q=tbn:ANd9GcQaa7JH1TX7xtU8SpR35IjPOWF7HSujPYnfqJy-FlHEfxv6HXq3tQ",43,1.2,8410,1733,6677,"Quisque porta volutpat erat. Quisque erat eros, viverra eget, congue eget, semper rutrum, nulla. Nunc purus.",80,6719,43,5.1,7256,772,6484
413,"People Will Talk",2000,"https://www.youtube.com/embed/BQcvHEkGaEA","https://encrypted-tbn0.gstatic.com/images?q=tbn:ANd9GcTpzv6ZkKQ_5fFlx242_ZFGnV3MuzyUBrlVMhbcTFBKJGCr7XxS",48,8.4,7576,1575,6001,"Cras non velit nec nisi vulputate nonummy. Maecenas tincidunt lacus at velit. Vivamus vel nulla eget eros elementum pellentesque.",26,8039,19,8.8,8715,218,8497
414,"When Time Ran Out...",2005,"https://www.youtube.com/embed/6W0KFTj50zI","https://encrypted-tbn0.gstatic.com/images?q=tbn:ANd9GcRJqLpbXoWWpbGuNXVAuF8Iy2X8EFCKx-z2jPdj5XGEL_wrFgzY",49,3.1,2795,1496,1299,"Curabitur at ipsum ac tellus semper interdum. Mauris ullamcorper purus sit amet nulla. Quisque arcu libero, rutrum ac, lobortis vel, dapibus at, diam.",44,7690,41,1.8,6662,3074,3588
415,"The Land Before Time XII: The Great Day of the Flyers",2011,"https://www.youtube.com/embed/uaTAhjdaEuY","https://encrypted-tbn0.gstatic.com/images?q=tbn:ANd9GcQ6bssTSRlLtGI7nwGNoiKWx9hXXrZsIq1bCgawmuzsVpmbrHCZ3g",95,4.7,6734,1733,5001,"Pellentesque at nulla. Suspendisse potenti. Cras in purus eu magna vulputate luctus.",38,1317,83,5.1,1360,2311,-951
416,"Block-Heads",2007,"https://www.youtube.com/embed/cYAtvv-wopk","https://encrypted-tbn0.gstatic.com/images?q=tbn:ANd9GcTXDcq3lfWD_dPTVpQSNf6H8Sg12ilkGrxNouqLt7Nra0lQvOOO",70,4.2,6006,898,5108,"Proin eu mi. Nulla ac enim. In tempor, turpis nec euismod scelerisque, quam turpis adipiscing lorem, vitae mattis nibh ligula nec sem.",64,8065,29,8.9,8611,6885,1726
417,"All These Women (För att inte tala om alla dessa kvinnor)",2010,"https://www.youtube.com/embed/oNTzFnMXT3E","https://encrypted-tbn0.gstatic.com/images?q=tbn:ANd9GcQ_K_OlRU89USb4Vi53WsTFwqiEXKhfRUVw08lWTiH5XSmSISDDwg",68,2.8,8496,923,7573,"Praesent id massa id nisl venenatis lacinia. Aenean sit amet justo. Morbi ut odio.",50,5410,17,6.3,2409,923,1486
418,"Condorman",1992,"https://www.youtube.com/embed/eqDHqOcXjRQ","https://encrypted-tbn0.gstatic.com/images?q=tbn:ANd9GcSfdl_pNap7w4wYTP7dhiozrcmHAmCcADuvkKlsj19tBpxYkq60LA",89,5.7,9683,2711,6972,"Sed ante. Vivamus tortor. Duis mattis egestas metus.",76,9805,29,6.9,6175,573,5602
419,"Operation 'Y' & Other Shurik's Adventures",1984,"https://www.youtube.com/embed/giIs-AEAX6Y","https://encrypted-tbn0.gstatic.com/images?q=tbn:ANd9GcQ5LAO-oqK_jHF33R_asKWptHCRYc_456jcsgrngpU6q8htwl24",26,4.9,7383,4712,2671,"Proin eu mi. Nulla ac enim. In tempor, turpis nec euismod scelerisque, quam turpis adipiscing lorem, vitae mattis nibh ligula nec sem.",58,3444,50,7.2,9683,2352,7331
420,"Little Boy Blue",1996,"https://www.youtube.com/embed/Bn9iowpSWRs","https://encrypted-tbn0.gstatic.com/images?q=tbn:ANd9GcRTcG2_JqWMZJOf6uyZm7vI1GQGSsjWkKgxCokuA40pthaOj9LOFQ",75,3.1,6175,879,5296,"Donec diam neque, vestibulum eget, vulputate ut, ultrices vel, augue. Vestibulum ante ipsum primis in faucibus orci luctus et ultrices posuere cubilia Curae; Donec pharetra, magna vestibulum aliquet ultrices, erat tortor sollicitudin mi, sit amet lobortis sapien sapien non mi. Integer ac neque.",100,5537,66,9.3,6734,2711,4023
421,"The Long Voyage Home",1977,"https://www.youtube.com/embed/1ywA8TtwJ50","https://encrypted-tbn0.gstatic.com/images?q=tbn:ANd9GcTZmxe1lfZxGWCEdh5BIO8o0IWoInXoMB0QURL9yFrayrcsRK7J",89,7.7,4324,6494,-2170,"Praesent blandit. Nam nulla. Integer pede justo, lacinia eget, tincidunt eget, tempus vel, pede.",100,8135,66,8.5,9683,2606,7077
422,"The Iran Job",2012,"https://www.youtube.com/embed/IU3xV9ZRYlk","https://encrypted-tbn0.gstatic.com/images?q=tbn:ANd9GcTpzv6ZkKQ_5fFlx242_ZFGnV3MuzyUBrlVMhbcTFBKJGCr7XxS",2,5.7,1191,2606,-1415,"Fusce consequat. Nulla nisl. Nunc nisl.",36,8234,96,8.1,3458,5228,-1770
423,"King Kong",2011,"https://www.youtube.com/embed/eqDHqOcXjRQ","https://encrypted-tbn0.gstatic.com/images?q=tbn:ANd9GcSC_qEbYtBeELogQVPTeiWNRbcOXlYKbMYmMPaG67T_yrWKEiTV",70,5.7,698,5206,-4508,"Maecenas ut massa quis augue luctus tincidunt. Nulla mollis molestie lorem. Quisque ut erat.",38,1277,36,8.5,692,1733,-1041
424,"Operation 'Y' & Other Shurik's Adventures",2006,"https://www.youtube.com/embed/COTt1zvBUJk","https://encrypted-tbn0.gstatic.com/images?q=tbn:ANd9GcSsoy4iP--KOCJ5pPhAcbfrQSvWLPYPI3I557hNf2Vfb6OrfrOczg",89,9.5,2987,6494,-3507,"Cras mi pede, malesuada in, imperdiet et, commodo vulputate, justo. In blandit ultrices enim. Lorem ipsum dolor sit amet, consectetuer adipiscing elit.",28,2840,3,3.4,6006,3428,2578
425,"The King",2011,"https://www.youtube.com/embed/G9T_f7DjYho","https://encrypted-tbn0.gstatic.com/images?q=tbn:ANd9GcSQ-QvEfMwKoUuWLDF2x2M1V4BTEN6-uoYrr8ShYvdSVQcHru6h",64,3.4,5529,4,5525,"Cras mi pede, malesuada in, imperdiet et, commodo vulputate, justo. In blandit ultrices enim. Lorem ipsum dolor sit amet, consectetuer adipiscing elit.",38,93,96,4.1,6869,3563,3306
426,"Jin Roh: The Wolf Brigade (Jin-Rô)",2000,"https://www.youtube.com/embed/6W0KFTj50zI","https://encrypted-tbn0.gstatic.com/images?q=tbn:ANd9GcQoGIgMrMpVA2TiWG8g9ENb7x-ZrciYB-gqzjyCnG-C2EgT8ePfkA",95,1.4,6469,1733,4736,"Nulla ut erat id mauris vulputate elementum. Nullam varius. Nulla facilisi.",26,8485,89,2.4,6469,47,6422
427,"The Sword of Doom",1968,"https://www.youtube.com/embed/cENucEoMZic","https://encrypted-tbn0.gstatic.com/images?q=tbn:ANd9GcQoGIgMrMpVA2TiWG8g9ENb7x-ZrciYB-gqzjyCnG-C2EgT8ePfkA",44,1.4,4324,2965,1359,"Cras mi pede, malesuada in, imperdiet et, commodo vulputate, justo. In blandit ultrices enim. Lorem ipsum dolor sit amet, consectetuer adipiscing elit.",50,1836,26,2.1,7890,225,7665
428,"Quand je serai petit",2012,"https://www.youtube.com/embed/DIOW-kR_ams","https://encrypted-tbn0.gstatic.com/images?q=tbn:ANd9GcSZ6r6rDjMvQsp22jqT0ZPe_z-oKhAWQcjwgB5egzck4lqzLHYHCg",49,8.5,9122,2308,6814,"Vestibulum quam sapien, varius ut, blandit non, interdum in, ante. Vestibulum ante ipsum primis in faucibus orci luctus et ultrices posuere cubilia Curae; Duis faucibus accumsan odio. Curabitur convallis.",88,281,75,6.8,6662,772,5890
429,"The Last Seduction",2011,"https://www.youtube.com/embed/LcepHRTWI18","https://encrypted-tbn0.gstatic.com/images?q=tbn:ANd9GcTpzv6ZkKQ_5fFlx242_ZFGnV3MuzyUBrlVMhbcTFBKJGCr7XxS",80,4.1,4602,6554,-1952,"Proin leo odio, porttitor id, consequat in, consequat ut, nulla. Sed accumsan felis. Ut at dolor quis odio consequat varius.",50,2822,3,5.1,6662,6494,168
430,"Beyond Therapy",1997,"https://www.youtube.com/embed/_c3WIprIGHE","https://encrypted-tbn0.gstatic.com/images?q=tbn:ANd9GcSOWY9FWNsfX_XrmFypiMILLGG-QtrQcxL8f5w3qsIiNjiSdC3x",49,7,198,6427,-6229,"Curabitur in libero ut massa volutpat convallis. Morbi odio odio, elementum eu, interdum eu, tincidunt in, leo. Maecenas pulvinar lobortis est.",38,5615,26,6.7,5529,7219,-1690
431,"Little Nikita",2010,"https://www.youtube.com/embed/eqDHqOcXjRQ","https://encrypted-tbn0.gstatic.com/images?q=tbn:ANd9GcQvfJ-vLQ5TK13ND8sY6H-r6cm_4f3SnW_WAWn2vuX-nGh6F8JquQ",19,1.8,8446,4196,4250,"Fusce consequat. Nulla nisl. Nunc nisl.",100,8056,55,8.8,2795,3539,-744
432,"Overnight Delivery",1989,"https://www.youtube.com/embed/THq6KlWgiqw","https://encrypted-tbn0.gstatic.com/images?q=tbn:ANd9GcRyMl7AW_r-FXiuqUSSUA5Mww484NZ8QAd_-vEbcfX2bB8j-uCn1g",82,2.4,6072,3428,2644,"Cras mi pede, malesuada in, imperdiet et, commodo vulputate, justo. In blandit ultrices enim. Lorem ipsum dolor sit amet, consectetuer adipiscing elit.",56,6673,69,2.4,6072,562,5510
433,"The Cell 2",1979,"https://www.youtube.com/embed/DIOW-kR_ams","https://encrypted-tbn0.gstatic.com/images?q=tbn:ANd9GcTTLFfQrJmhvXjL4d_udm6Z89QYglVi4hTEmbaDRdDoqHQsaQVg",89,6.7,8715,215,8500,"Nam ultrices, libero non mattis pulvinar, nulla pede ullamcorper augue, a suscipit nulla elit ac nulla. Sed vel enim sit amet nunc viverra dapibus. Nulla suscipit ligula in lacus.",50,8039,56,9.7,8301,218,8083
434,"U2: Rattle and Hum",2012,"https://www.youtube.com/embed/Bn9iowpSWRs","https://encrypted-tbn0.gstatic.com/images?q=tbn:ANd9GcQ4tG7BC0SE2SNUji4NBAmTKKl13L-IuMZpkiEbQm0YeWk9Z1SQUg",90,6.7,2481,1061,1420,"Aliquam quis turpis eget elit sodales scelerisque. Mauris sit amet eros. Suspendisse accumsan tortor quis turpis.",88,607,49,1.1,3530,3607,-77
435,"Another Woman",2010,"https://www.youtube.com/embed/2BoyDp49C6Y","https://encrypted-tbn0.gstatic.com/images?q=tbn:ANd9GcQ1aky5NsvfU2oObNVwH5j9ZHJNNcxRkRhHEYTh8yhtqNLPmxk0lA",4,3.2,2034,215,1819,"In congue. Etiam justo. Etiam pretium iaculis justo.",64,4185,37,1.5,1191,1592,-401
436,"Dorado, El",1986,"https://www.youtube.com/embed/QJlh0IPQbbo","https://encrypted-tbn0.gstatic.com/images?q=tbn:ANd9GcQ1aky5NsvfU2oObNVwH5j9ZHJNNcxRkRhHEYTh8yhtqNLPmxk0lA",44,6.9,7715,772,6943,"Maecenas leo odio, condimentum id, luctus nec, molestie sed, justo. Pellentesque viverra pede ac diam. Cras pellentesque volutpat dui.",44,7438,95,9.3,5696,1374,4322
437,"Iceberg, L'",1998,"https://www.youtube.com/embed/G9T_f7DjYho","https://images-na.ssl-images-amazon.com/images/I/41SFojuU1FL._SY600_.jpg",49,1,698,2198,-1500,"Cras non velit nec nisi vulputate nonummy. Maecenas tincidunt lacus at velit. Vivamus vel nulla eget eros elementum pellentesque.",22,2682,70,3.1,8301,8004,297
438,"When Time Ran Out...",2008,"https://www.youtube.com/embed/oNTzFnMXT3E","https://encrypted-tbn0.gstatic.com/images?q=tbn:ANd9GcQ1aky5NsvfU2oObNVwH5j9ZHJNNcxRkRhHEYTh8yhtqNLPmxk0lA",56,4.8,753,1504,-751,"Maecenas ut massa quis augue luctus tincidunt. Nulla mollis molestie lorem. Quisque ut erat.",76,6777,6,4.4,8454,537,7917
439,"The Paradine Case",2001,"https://www.youtube.com/embed/YVYzxm_RqMg","https://encrypted-tbn0.gstatic.com/images?q=tbn:ANd9GcSRkE8RSex-89LA2Msfb1Vq6eH047lvDYppmp9IwK2zLgw2nbE-Uw",7,6,2987,1504,1483,"Quisque porta volutpat erat. Quisque erat eros, viverra eget, congue eget, semper rutrum, nulla. Nunc purus.",82,7612,62,6.9,198,562,-364
440,"Hype!",2012,"https://www.youtube.com/embed/MNp1LPm3Krs","https://i.pinimg.com/736x/37/a0/99/37a099570abb65e478268af396315658--brochure-design-colour-combinations.jpg",41,2.4,9696,6366,3330,"Cras non velit nec nisi vulputate nonummy. Maecenas tincidunt lacus at velit. Vivamus vel nulla eget eros elementum pellentesque.",82,25,50,1.2,284,1560,-1276
441,"The Cell 2",2002,"https://www.youtube.com/embed/fnLjm_yL7vE","https://encrypted-tbn0.gstatic.com/images?q=tbn:ANd9GcSJJAS-aY5yM_o538SFwYJKMI1ICZvCAEdnVZX59tINRulVx7aBpA",22,6,8496,5471,3025,"Lorem ipsum dolor sit amet, consectetuer adipiscing elit. Proin risus. Praesent lectus.",34,5615,19,4.1,4108,2001,2107
442,"Breaking the Silence: Truth and Lies in the War on Terror",2012,"https://www.youtube.com/embed/XtgCqMZofqM","https://encrypted-tbn0.gstatic.com/images?q=tbn:ANd9GcT5qYZ7WL1XpLSuZms35fvGdxwAwN8ZoDje7zRyyFHfFSsWWAHelQ",96,9.6,2883,1822,1061,"Nam ultrices, libero non mattis pulvinar, nulla pede ullamcorper augue, a suscipit nulla elit ac nulla. Sed vel enim sit amet nunc viverra dapibus. Nulla suscipit ligula in lacus.",86,510,65,4.8,7900,5209,2691
443,"Confidence",2001,"https://www.youtube.com/embed/MaI-4NepPfU","https://encrypted-tbn0.gstatic.com/images?q=tbn:ANd9GcSigGMCEOHmqUMTkf9z3wcQTZlj2VM5cRueb-YgaX9_Hkej2qI5mQ",13,2.9,7715,2617,5098,"Donec diam neque, vestibulum eget, vulputate ut, ultrices vel, augue. Vestibulum ante ipsum primis in faucibus orci luctus et ultrices posuere cubilia Curae; Donec pharetra, magna vestibulum aliquet ultrices, erat tortor sollicitudin mi, sit amet lobortis sapien sapien non mi. Integer ac neque.",60,4799,20,4.4,2847,4,2843
444,"The Indian Runner",2005,"https://www.youtube.com/embed/oP-fRX_gB6o","https://i.pinimg.com/236x/5f/f6/69/5ff6693c3694f55e8ed9738084c4c6b1--d-design-design-concepts.jpg",56,9.6,8226,923,7303,"Lorem ipsum dolor sit amet, consectetuer adipiscing elit. Proin risus. Praesent lectus.",32,5410,26,5.1,9122,225,8897
445,"The Possession of Michael King",1994,"https://www.youtube.com/embed/MpJEOpsVWtA","https://encrypted-tbn0.gstatic.com/images?q=tbn:ANd9GcTohJTJK1v5tSnhy3g7gvaali5Xq0Qq6MwRJMGVD5enka23vy2H",35,6.2,7900,1733,6167,"Integer ac leo. Pellentesque ultrices mattis odio. Donec vitae nisi.",96,1948,55,1.8,9696,361,9335
446,"The Land Before Time XII: The Great Day of the Flyers",2012,"https://www.youtube.com/embed/KbZ3TVEkuDY","https://encrypted-tbn0.gstatic.com/images?q=tbn:ANd9GcTohJTJK1v5tSnhy3g7gvaali5Xq0Qq6MwRJMGVD5enka23vy2H",41,2.4,3530,361,3169,"Suspendisse potenti. In eleifend quam a odio. In hac habitasse platea dictumst.",40,6113,29,5.4,4324,1504,2820
447,"When Time Ran Out...",2006,"https://www.youtube.com/embed/ee12SvnnrSw","https://encrypted-tbn0.gstatic.com/images?q=tbn:ANd9GcRXW_MDHretVBvFBnfeqtLtE86uQkY-GTeOH_gP8OZY1Znu6a86qg",56,1.1,6006,1590,4416,"Proin eu mi. Nulla ac enim. In tempor, turpis nec euismod scelerisque, quam turpis adipiscing lorem, vitae mattis nibh ligula nec sem.",96,9431,10,3.4,2481,2999,-518
448,"The King",1998,"https://www.youtube.com/embed/IU3xV9ZRYlk","https://encrypted-tbn0.gstatic.com/images?q=tbn:ANd9GcSsoy4iP--KOCJ5pPhAcbfrQSvWLPYPI3I557hNf2Vfb6OrfrOczg",56,4.8,5146,4020,1126,"Duis bibendum. Morbi non quam nec dui luctus rutrum. Nulla tellus.",48,2866,26,9.3,8410,156,8254
449,"Lust for Gold",2002,"https://www.youtube.com/embed/l-u3PdA-rpY","https://encrypted-tbn0.gstatic.com/images?q=tbn:ANd9GcSYy4S-T_nbr708KkpYcV-RgmyX_MPtCXzFVr44X7S9CAQsyQAE3Q",6,1.1,8446,2489,5957,"Proin eu mi. Nulla ac enim. In tempor, turpis nec euismod scelerisque, quam turpis adipiscing lorem, vitae mattis nibh ligula nec sem.",96,4252,66,2.4,3801,3371,430
450,"The Living Magoroku",1993,"https://www.youtube.com/embed/Bn9iowpSWRs","https://encrypted-tbn0.gstatic.com/images?q=tbn:ANd9GcTVx6QbLHPUKkVSj1TkaOANhnRfjtIXHhKnHSaIR2y3RkCgry-X",77,1.8,2987,6885,-3898,"Quisque porta volutpat erat. Quisque erat eros, viverra eget, congue eget, semper rutrum, nulla. Nunc purus.",40,2153,60,9.3,5529,2606,2923
451,"Level Five",2012,"https://www.youtube.com/embed/Rc3e0m6SpXo","https://encrypted-tbn0.gstatic.com/images?q=tbn:ANd9GcS0uoN_00qCw12_q1GgGAdcbA-6sp6JzFguYZMxLObI8Ydh9OBk",18,7.7,3530,2617,913,"Praesent blandit. Nam nulla. Integer pede justo, lacinia eget, tincidunt eget, tempus vel, pede.",40,4185,49,1.2,2323,176,2147
452,"Clifford",2010,"https://www.youtube.com/embed/_aHDqS8EMn0","https://encrypted-tbn0.gstatic.com/images?q=tbn:ANd9GcRxLYJSuzc9AAuuJ3R1HulbKM_T8_whdwPZQj7VyYonHOME6fYq",7,2.4,8437,1575,6862,"Maecenas ut massa quis augue luctus tincidunt. Nulla mollis molestie lorem. Quisque ut erat.",26,1379,62,4.2,6072,4124,1948
453,"Escaflowne: The Movie (Escaflowne)",2005,"https://www.youtube.com/embed/ee12SvnnrSw","https://encrypted-tbn0.gstatic.com/images?q=tbn:ANd9GcSAeZgM34QBLW9W6aAQ7xBcJIa1KwtfVVcFHkKpsxvOjDBmNvh0",4,3.4,5696,3371,2325,"Morbi porttitor lorem id ligula. Suspendisse ornare consequat lectus. In est risus, auctor sed, tristique in, tempus sit amet, sem.",32,3444,20,2.1,8382,2489,5893
454,"Jin Roh: The Wolf Brigade (Jin-Rô)",1985,"https://www.youtube.com/embed/h-k0-Z9b4Cw","https://encrypted-tbn0.gstatic.com/images?q=tbn:ANd9GcQhhglaTqXYejQ2b9TYl15F3E4pAgR1pWjyYyUTJgkHGuKsiWyHrw",80,3.2,6275,156,6119,"In sagittis dui vel nisl. Duis ac nibh. Fusce lacus purus, aliquet at, feugiat non, pretium quis, lectus.",50,7069,78,8.9,698,1545,-847
455,"The Big Trail",2012,"https://www.youtube.com/embed/IU3xV9ZRYlk","https://encrypted-tbn0.gstatic.com/images?q=tbn:ANd9GcS_NoH0Aw_5YFsBFwfBPn_O7YPHXumI5V3iQ2s7B-3zPU_7sSm1gA",34,9.1,7683,8629,-946,"Fusce consequat. Nulla nisl. Nunc nisl.",28,6868,30,4.2,2269,8964,-6695
456,"Aloft",2012,"https://www.youtube.com/embed/LO9I2fpyUyg","https://encrypted-tbn0.gstatic.com/images?q=tbn:ANd9GcQ6bssTSRlLtGI7nwGNoiKWx9hXXrZsIq1bCgawmuzsVpmbrHCZ3g",66,2.8,6275,2606,3669,"Donec diam neque, vestibulum eget, vulputate ut, ultrices vel, augue. Vestibulum ante ipsum primis in faucibus orci luctus et ultrices posuere cubilia Curae; Donec pharetra, magna vestibulum aliquet ultrices, erat tortor sollicitudin mi, sit amet lobortis sapien sapien non mi. Integer ac neque.",80,8135,43,6.7,1360,5228,-3868
457,"Rabid Grannies (Mémés cannibales, Les)",2009,"https://www.youtube.com/embed/B12REtkl2KY","https://encrypted-tbn0.gstatic.com/images?q=tbn:ANd9GcT11kibbY7ZQKvhvKatIRRKfv-n-n77Ve-QuVdMOoMg-fol_k9j",66,3.1,8410,831,7579,"Proin leo odio, porttitor id, consequat in, consequat ut, nulla. Sed accumsan felis. Ut at dolor quis odio consequat varius.",64,9857,24,8.8,8377,8004,373
458,"Condorman",2008,"https://www.youtube.com/embed/MExr5cmGsC4","https://encrypted-tbn0.gstatic.com/images?q=tbn:ANd9GcRqaaKELSsRKJh2pc05f1s5ksCTCIa-bgxbzGUm2T7leAI2nlTqZw",20,7,8446,772,7674,"Donec diam neque, vestibulum eget, vulputate ut, ultrices vel, augue. Vestibulum ante ipsum primis in faucibus orci luctus et ultrices posuere cubilia Curae; Donec pharetra, magna vestibulum aliquet ultrices, erat tortor sollicitudin mi, sit amet lobortis sapien sapien non mi. Integer ac neque.",76,9431,28,9.5,8454,1374,7080
459,"Joe Kidd",2012,"https://www.youtube.com/embed/Sw_5YPAf7Zs","https://encrypted-tbn0.gstatic.com/images?q=tbn:ANd9GcRauFfIne8mHbF9MCn-LxY8C6gHqalPefcj6s8z0B9JZwEnD5A4",28,2.4,5704,5209,495,"Quisque porta volutpat erat. Quisque erat eros, viverra eget, congue eget, semper rutrum, nulla. Nunc purus.",60,6159,43,8.1,3411,3607,-196
460,"Hype!",2012,"https://www.youtube.com/embed/3_bUymlkSuA","https://encrypted-tbn0.gstatic.com/images?q=tbn:ANd9GcQN3_I47i-MkaTBmK9e2PzNkhGoJsWeB5U_dn5cat3hDSHLCPjU",96,1.7,1360,3607,-2247,"Cras non velit nec nisi vulputate nonummy. Maecenas tincidunt lacus at velit. Vivamus vel nulla eget eros elementum pellentesque.",66,4828,55,2.4,2779,7219,-4440
461,"Meet the Fockers",1994,"https://www.youtube.com/embed/PdL8kn_G5EQ","https://encrypted-tbn0.gstatic.com/images?q=tbn:ANd9GcTZlJW6ILTHoyypnMTvpWTFl3IhTXHYM5kQntofSVvdKEozMRsTxQ",22,9.6,6662,7462,-800,"Curabitur in libero ut massa volutpat convallis. Morbi odio odio, elementum eu, interdum eu, tincidunt in, leo. Maecenas pulvinar lobortis est.",50,4185,50,1,2409,1983,426
462,"Hardcore",2011,"https://www.youtube.com/embed/8oTXc5t35Ro","https://encrypted-tbn0.gstatic.com/images?q=tbn:ANd9GcSBKrAU7qHXZ_vqij5HmW3xvTgSZ9qA7lT4fxAsUEXHGvWHHXai",3,1,7900,3313,4587,"Suspendisse potenti. In eleifend quam a odio. In hac habitasse platea dictumst.",70,4526,41,4.4,2733,1592,1141
463,"Hype!",1999,"https://www.youtube.com/embed/I7YdOosOjTU","https://encrypted-tbn0.gstatic.com/images?q=tbn:ANd9GcTiS27rf1ltLwxOAbTBhYvqJuvJG8ctIALtoknQh7MHlvV3r0UO",77,6.8,4602,1560,3042,"Pellentesque at nulla. Suspendisse potenti. Cras in purus eu magna vulputate luctus.",50,1836,34,6.8,4602,156,4446
464,"Dorado, El",1985,"https://www.youtube.com/embed/VccwBGgyzP4","https://encrypted-tbn0.gstatic.com/images?q=tbn:ANd9GcQ1NxrNXukXKIzYZ8UbVazSnR-5741v5UDQPpMMVUvn_2I28fMZ",81,5.9,4286,47,4239,"Donec diam neque, vestibulum eget, vulputate ut, ultrices vel, augue. Vestibulum ante ipsum primis in faucibus orci luctus et ultrices posuere cubilia Curae; Donec pharetra, magna vestibulum aliquet ultrices, erat tortor sollicitudin mi, sit amet lobortis sapien sapien non mi. Integer ac neque.",28,9441,6,9.1,5542,5206,336
465,"Azumi 2: Death or Love",2011,"https://www.youtube.com/embed/G9T_f7DjYho","https://encrypted-tbn0.gstatic.com/images?q=tbn:ANd9GcRyMl7AW_r-FXiuqUSSUA5Mww484NZ8QAd_-vEbcfX2bB8j-uCn1g",42,1.8,7162,781,6381,"Donec diam neque, vestibulum eget, vulputate ut, ultrices vel, augue. Vestibulum ante ipsum primis in faucibus orci luctus et ultrices posuere cubilia Curae; Donec pharetra, magna vestibulum aliquet ultrices, erat tortor sollicitudin mi, sit amet lobortis sapien sapien non mi. Integer ac neque.",82,8039,4,7.7,4286,8964,-4678
466,"Blow Out",2012,"https://www.youtube.com/embed/PdL8kn_G5EQ","https://encrypted-tbn0.gstatic.com/images?q=tbn:ANd9GcQInYhbERWHKRlaq1eJAqZqaGQ9zndtpCyGofdPFToPGHuZUGCS",80,9.5,6006,6494,-488,"Lorem ipsum dolor sit amet, consectetuer adipiscing elit. Proin risus. Praesent lectus.",40,458,78,6.7,3417,5515,-2098
467,"Transylvania",2000,"https://www.youtube.com/embed/ee12SvnnrSw","https://encrypted-tbn0.gstatic.com/images?q=tbn:ANd9GcS0uoN_00qCw12_q1GgGAdcbA-6sp6JzFguYZMxLObI8Ydh9OBk",56,6,7576,176,7400,"Proin leo odio, porttitor id, consequat in, consequat ut, nulla. Sed accumsan felis. Ut at dolor quis odio consequat varius.",70,223,55,6.1,9416,1733,7683
468,"Holy Flame of the Martial World (Wu lin sheng huo jin)",1998,"https://www.youtube.com/embed/COTt1zvBUJk","https://encrypted-tbn0.gstatic.com/images?q=tbn:ANd9GcSf2dfgX6MEnaRNwWQSyRmKHm53LfBYmW9pJJCfqjE0BKijzycS",68,9.5,3923,7219,-3296,"Nulla ut erat id mauris vulputate elementum. Nullam varius. Nulla facilisi.",80,1528,42,9.3,6386,3371,3015
469,"AVPR: Aliens vs. Predator - Requiem",1997,"https://www.youtube.com/embed/MExr5cmGsC4","https://encrypted-tbn0.gstatic.com/images?q=tbn:ANd9GcQ-Bo62SqPu_RKYOfA9eW-LQjqldSZ02v2_G5-UJtSlr8Qd948lLA",75,9,2777,1496,1281,"Quisque id justo sit amet sapien dignissim vestibulum. Vestibulum ante ipsum primis in faucibus orci luctus et ultrices posuere cubilia Curae; Nulla dapibus dolor vel est. Donec odio justo, sollicitudin ut, suscipit a, feugiat et, eros.",26,8039,43,4.4,8816,7659,1157
470,"The Paradine Case",2004,"https://www.youtube.com/embed/iW3t_wUDG5U","https://encrypted-tbn0.gstatic.com/images?q=tbn:ANd9GcSOWY9FWNsfX_XrmFypiMILLGG-QtrQcxL8f5w3qsIiNjiSdC3x",50,6.8,8388,73,8315,"Pellentesque at nulla. Suspendisse potenti. Cras in purus eu magna vulputate luctus.",22,1589,4,5.1,198,5,193
471,"The Browning Version",1991,"https://www.youtube.com/embed/7C2Nad0aMPg","https://i.pinimg.com/236x/77/50/b3/7750b3ebe0787ae8e9beb7e2615e3b01.jpg",26,2.8,132,831,-699,"Aliquam quis turpis eget elit sodales scelerisque. Mauris sit amet eros. Suspendisse accumsan tortor quis turpis.",88,5410,77,6.8,6275,2777,3498
472,"Level Five",1998,"https://www.youtube.com/embed/vuzplFd3YVY","https://encrypted-tbn0.gstatic.com/images?q=tbn:ANd9GcRXW_MDHretVBvFBnfeqtLtE86uQkY-GTeOH_gP8OZY1Znu6a86qg",80,5.9,6774,3648,3126,"Quisque id justo sit amet sapien dignissim vestibulum. Vestibulum ante ipsum primis in faucibus orci luctus et ultrices posuere cubilia Curae; Nulla dapibus dolor vel est. Donec odio justo, sollicitudin ut, suscipit a, feugiat et, eros.",50,8647,56,1.1,7900,2311,5589
473,"Bird of Paradise",1997,"https://www.youtube.com/embed/3svtRyLq3b0","https://encrypted-tbn0.gstatic.com/images?q=tbn:ANd9GcSfdl_pNap7w4wYTP7dhiozrcmHAmCcADuvkKlsj19tBpxYkq60LA",9,7.2,2777,218,2559,"Pellentesque at nulla. Suspendisse potenti. Cras in purus eu magna vulputate luctus.",50,1317,34,7.5,1795,5515,-3720
474,"Sgt. Bilko",2001,"https://www.youtube.com/embed/iW3t_wUDG5U","https://encrypted-tbn0.gstatic.com/images?q=tbn:ANd9GcQYYT2HR82Tm6jDN6B_0-JbBC3HMcVQoxrwz0iiWHkiPx0sXczovQ",26,9,6386,5228,1158,"Maecenas tristique, est et tempus semper, est quam pharetra magna, ac consequat metus sapien ut nunc. Vestibulum ante ipsum primis in faucibus orci luctus et ultrices posuere cubilia Curae; Mauris viverra diam vitae quam. Suspendisse potenti.",22,8234,70,2.1,4286,361,3925
475,"Fair Game",2008,"https://www.youtube.com/embed/SF0w2B6DNUE","https://encrypted-tbn0.gstatic.com/images?q=tbn:ANd9GcRqaaKELSsRKJh2pc05f1s5ksCTCIa-bgxbzGUm2T7leAI2nlTqZw",81,1.2,7683,1374,6309,"Phasellus in felis. Donec semper sapien a libero. Nam dui.",64,7498,26,1.4,5146,2198,2948
476,"Vicky Donor",2012,"https://www.youtube.com/embed/3svtRyLq3b0","https://encrypted-tbn0.gstatic.com/images?q=tbn:ANd9GcRUMZIkgEW4ZtYyXTgo6uGdYksy7dreOkd-zJRc1uGna-GAnU3SDQ",70,3.4,6755,3527,3228,"Nam ultrices, libero non mattis pulvinar, nulla pede ullamcorper augue, a suscipit nulla elit ac nulla. Sed vel enim sit amet nunc viverra dapibus. Nulla suscipit ligula in lacus.",70,8056,30,4.3,7683,6494,1189
477,"Hype!",2006,"https://www.youtube.com/embed/RyYFAqJFYdE","https://encrypted-tbn0.gstatic.com/images?q=tbn:ANd9GcSRkE8RSex-89LA2Msfb1Vq6eH047lvDYppmp9IwK2zLgw2nbE-Uw",66,1.5,7256,781,6475,"Cras non velit nec nisi vulputate nonummy. Maecenas tincidunt lacus at velit. Vivamus vel nulla eget eros elementum pellentesque.",64,3074,3,6.9,2323,1560,763
478,"The Law of the Weakest",1965,"https://www.youtube.com/embed/THq6KlWgiqw","https://encrypted-tbn0.gstatic.com/images?q=tbn:ANd9GcSOWY9FWNsfX_XrmFypiMILLGG-QtrQcxL8f5w3qsIiNjiSdC3x",65,2.8,7393,176,7217,"Donec diam neque, vestibulum eget, vulputate ut, ultrices vel, augue. Vestibulum ante ipsum primis in faucibus orci luctus et ultrices posuere cubilia Curae; Donec pharetra, magna vestibulum aliquet ultrices, erat tortor sollicitudin mi, sit amet lobortis sapien sapien non mi. Integer ac neque.",26,6673,40,3.9,6579,1496,5083
479,"From Beijing with Love",2009,"https://www.youtube.com/embed/zCecE7OyVMU","https://encrypted-tbn0.gstatic.com/images?q=tbn:ANd9GcR6OdK3cVIVUn07PmO7zFQb1JyTfdi6L4FwxFWOD9dfwTwN4hEt",69,3.8,4286,5284,-998,"Aliquam quis turpis eget elit sodales scelerisque. Mauris sit amet eros. Suspendisse accumsan tortor quis turpis.",82,5615,66,4.7,9090,3539,5551
480,"The Prisoner",2012,"https://www.youtube.com/embed/l-u3PdA-rpY","https://encrypted-tbn0.gstatic.com/images?q=tbn:ANd9GcSkjHflFbGJwA3Dk6FW71ynZ5C6z_y9dkcX7Q0Q-2NSkRIUerlH",96,5.7,9496,3539,5957,"Duis aliquam convallis nunc. Proin at turpis a pede posuere nonummy. Integer non velit.",38,4185,89,2.1,9585,4196,5389
481,"Overnight Delivery",1985,"https://www.youtube.com/embed/uaTAhjdaEuY","https://encrypted-tbn0.gstatic.com/images?q=tbn:ANd9GcQX7g7WDTuGnT2syPcShrXK1gFJn4uMaACeAnWvesheIZXX58K1",77,8.9,9822,176,9646,"Pellentesque at nulla. Suspendisse potenti. Cras in purus eu magna vulputate luctus.",70,6159,26,1.5,8226,627,7599
482,"The Gaucho",2012,"https://www.youtube.com/embed/LO9I2fpyUyg","https://encrypted-tbn0.gstatic.com/images?q=tbn:ANd9GcTZlJW6ILTHoyypnMTvpWTFl3IhTXHYM5kQntofSVvdKEozMRsTxQ",98,2.1,2409,7659,-5250,"Proin leo odio, porttitor id, consequat in, consequat ut, nulla. Sed accumsan felis. Ut at dolor quis odio consequat varius.",60,2629,26,7.7,2034,6427,-4393
483,"Azumi 2: Death or Love",1991,"https://www.youtube.com/embed/OWwVD1xdAX4","https://encrypted-tbn0.gstatic.com/images?q=tbn:ANd9GcQaa7JH1TX7xtU8SpR35IjPOWF7HSujPYnfqJy-FlHEfxv6HXq3tQ",69,3.2,6734,1061,5673,"Proin eu mi. Nulla ac enim. In tempor, turpis nec euismod scelerisque, quam turpis adipiscing lorem, vitae mattis nibh ligula nec sem.",62,694,35,1.8,8377,3421,4956
484,"Escaflowne: The Movie (Escaflowne)",1999,"https://www.youtube.com/embed/VUEaDUyeTR8","https://encrypted-tbn0.gstatic.com/images?q=tbn:ANd9GcRmeUcg7O8EkPtcOaGTwx1hvLuj5TbCPLmfq_zT0IhPpcbOWbBUDA",81,3.1,8454,562,7892,"Nulla ut erat id mauris vulputate elementum. Nullam varius. Nulla facilisi.",82,7702,49,7.5,3801,1575,2226
485,"Edmond",2006,"https://www.youtube.com/embed/THq6KlWgiqw","https://i.pinimg.com/236x/3b/29/73/3b2973cc00e87a821ad68647747259be--pattern-texture-paints.jpg",13,8.3,5160,1025,4135,"Aliquam quis turpis eget elit sodales scelerisque. Mauris sit amet eros. Suspendisse accumsan tortor quis turpis.",38,962,61,1.2,3417,3607,-190
486,"Aloft",2012,"https://www.youtube.com/embed/RaA9elSYnpQ","https://encrypted-tbn0.gstatic.com/images?q=tbn:ANd9GcQhhglaTqXYejQ2b9TYl15F3E4pAgR1pWjyYyUTJgkHGuKsiWyHrw",70,2.9,12,225,-213,"Lorem ipsum dolor sit amet, consectetuer adipiscing elit. Proin risus. Praesent lectus.",48,694,28,4.1,3530,2617,913
487,"American Pie Presents The Naked Mile (American Pie 5: The Naked Mile)",1995,"https://www.youtube.com/embed/jEnIfGQ_UuQ","https://encrypted-tbn0.gstatic.com/images?q=tbn:ANd9GcR6OdK3cVIVUn07PmO7zFQb1JyTfdi6L4FwxFWOD9dfwTwN4hEt",19,9.6,8715,1496,7219,"Integer ac leo. Pellentesque ultrices mattis odio. Donec vitae nisi.",60,5258,77,7.7,8226,3563,4663
488,"Gunday",1997,"https://www.youtube.com/embed/1roy4o4tqQM","https://encrypted-tbn0.gstatic.com/images?q=tbn:ANd9GcQoGIgMrMpVA2TiWG8g9ENb7x-ZrciYB-gqzjyCnG-C2EgT8ePfkA",49,3.4,6006,3527,2479,"Proin eu mi. Nulla ac enim. In tempor, turpis nec euismod scelerisque, quam turpis adipiscing lorem, vitae mattis nibh ligula nec sem.",36,7498,31,2.1,2847,2606,241
489,"Jin Roh: The Wolf Brigade (Jin-Rô)",2011,"https://www.youtube.com/embed/_c3WIprIGHE","https://encrypted-tbn0.gstatic.com/images?q=tbn:ANd9GcSmZDfgAQh9gNhDHM4YtECFcKd6iXDTMrn-PXI6Wylc9Lddn5ah-w",28,6.7,698,54,644,"Cras mi pede, malesuada in, imperdiet et, commodo vulputate, justo. In blandit ultrices enim. Lorem ipsum dolor sit amet, consectetuer adipiscing elit.",50,962,43,7.8,3801,1025,2776
490,"7 Women (a.k.a. Seven Women)",1996,"https://www.youtube.com/embed/8W6yYBAUxv4","https://encrypted-tbn0.gstatic.com/images?q=tbn:ANd9GcTlHaTq59e08Zugqn9ZX71XQYUOtuUGEQ9Mkl_HR1NmuSBceL7O",36,2.4,9090,7659,1431,"Aliquam quis turpis eget elit sodales scelerisque. Mauris sit amet eros. Suspendisse accumsan tortor quis turpis.",96,2153,60,8.4,3923,6427,-2504
491,"Block-Heads",2002,"https://www.youtube.com/embed/oP-fRX_gB6o","https://encrypted-tbn0.gstatic.com/images?q=tbn:ANd9GcRboE_Oz4pmq_fbkSzc09GrZ6-FxQU9Zh64Y6b3LNLomLOlE4VEzQ",43,8.3,2323,73,2250,"Aliquam quis turpis eget elit sodales scelerisque. Mauris sit amet eros. Suspendisse accumsan tortor quis turpis.",26,6159,81,4.7,6175,5209,966
492,"The Sword of Doom",1989,"https://www.youtube.com/embed/MpJEOpsVWtA","https://encrypted-tbn0.gstatic.com/images?q=tbn:ANd9GcQ4tG7BC0SE2SNUji4NBAmTKKl13L-IuMZpkiEbQm0YeWk9Z1SQUg",81,6.8,5943,4,5939,"Proin eu mi. Nulla ac enim. In tempor, turpis nec euismod scelerisque, quam turpis adipiscing lorem, vitae mattis nibh ligula nec sem.",48,962,64,6.1,2847,2198,649
493,"Gunday",2001,"https://www.youtube.com/embed/MaI-4NepPfU","https://encrypted-tbn0.gstatic.com/images?q=tbn:ANd9GcSnUCe3jwoe6TiIdg0tv_j25Q3WHNDjeBfzqlYhOl70hy95_k9t1Q",96,8.1,12,537,-525,"Duis aliquam convallis nunc. Proin at turpis a pede posuere nonummy. Integer non velit.",22,5258,81,9.3,8454,6892,1562
494,"Iceberg, L'",1999,"https://www.youtube.com/embed/oNTzFnMXT3E","https://encrypted-tbn0.gstatic.com/images?q=tbn:ANd9GcS_NoH0Aw_5YFsBFwfBPn_O7YPHXumI5V3iQ2s7B-3zPU_7sSm1gA",62,1,6869,54,6815,"Curabitur in libero ut massa volutpat convallis. Morbi odio odio, elementum eu, interdum eu, tincidunt in, leo. Maecenas pulvinar lobortis est.",74,4907,28,4.8,2883,1983,900
495,"Coming Down the Mountain",2011,"https://www.youtube.com/embed/dfUJm6XgD7g","https://encrypted-tbn0.gstatic.com/images?q=tbn:ANd9GcQInYhbERWHKRlaq1eJAqZqaGQ9zndtpCyGofdPFToPGHuZUGCS",4,1.5,9683,1496,8187,"Sed sagittis. Nam congue, risus semper porta volutpat, quam pede lobortis ligula, sit amet eleifend pede libero quis orci. Nullam molestie nibh in lectus.",42,8056,62,5.7,9090,4196,4894
496,"The Last Seduction",2009,"https://www.youtube.com/embed/dfUJm6XgD7g","https://encrypted-tbn0.gstatic.com/images?q=tbn:ANd9GcTZlJW6ILTHoyypnMTvpWTFl3IhTXHYM5kQntofSVvdKEozMRsTxQ",98,5.1,6199,3421,2778,"Aliquam quis turpis eget elit sodales scelerisque. Mauris sit amet eros. Suspendisse accumsan tortor quis turpis.",28,3074,48,3.1,8454,73,8381
497,"King Kong",2002,"https://www.youtube.com/embed/6Ui6m_eEEOI","https://encrypted-tbn0.gstatic.com/images?q=tbn:ANd9GcT11kibbY7ZQKvhvKatIRRKfv-n-n77Ve-QuVdMOoMg-fol_k9j",22,4.1,8377,3074,5303,"Cras mi pede, malesuada in, imperdiet et, commodo vulputate, justo. In blandit ultrices enim. Lorem ipsum dolor sit amet, consectetuer adipiscing elit.",50,5941,20,2.4,9585,4125,5460
498,"The Poseidon Adventure",2009,"https://www.youtube.com/embed/DIOW-kR_ams","https://encrypted-tbn0.gstatic.com/images?q=tbn:ANd9GcSZ6r6rDjMvQsp22jqT0ZPe_z-oKhAWQcjwgB5egzck4lqzLHYHCg",41,4.1,8446,7462,984,"Curabitur in libero ut massa volutpat convallis. Morbi odio odio, elementum eu, interdum eu, tincidunt in, leo. Maecenas pulvinar lobortis est.",88,25,98,8.4,6869,263,6606
499,"Dragon Ball Z the Movie: The World's Strongest (a.k.a. Dragon Ball Z: The Strongest Guy in The World) (Doragon bôru Z: Kono yo de ichiban tsuyoi yatsu)",2012,"https://www.youtube.com/embed/IU3xV9ZRYlk","https://encrypted-tbn0.gstatic.com/images?q=tbn:ANd9GcSfenuQRjGbddBAE4j3I_GN73Ch-EI9uairOfxWWbLQYAluLoDWCQ",61,1.7,2016,3428,-1412,"In sagittis dui vel nisl. Duis ac nibh. Fusce lacus purus, aliquet at, feugiat non, pretium quis, lectus.",74,9441,70,8.3,3801,263,3538
500,"Bird of Paradise",2010,"https://www.youtube.com/embed/YVYzxm_RqMg","https://encrypted-tbn0.gstatic.com/images?q=tbn:ANd9GcRfaybDSA3hF-btWMAObj0lbtp7UbFPvvC41dZ9EEL1BMISwxF6",64,8.1,132,3607,-3475,"Quisque porta volutpat erat. Quisque erat eros, viverra eget, congue eget, semper rutrum, nulla. Nunc purus.",56,1836,38,7,5529,772,4757
501,"Elvis Meets Nixon",1985,"https://www.youtube.com/embed/Xwzwmc2AZYg","https://encrypted-tbn0.gstatic.com/images?q=tbn:ANd9GcSsoy4iP--KOCJ5pPhAcbfrQSvWLPYPI3I557hNf2Vfb6OrfrOczg",4,2.4,6755,3118,3637,"In hac habitasse platea dictumst. Etiam faucibus cursus urna. Ut tellus.",60,9857,68,2.8,2269,4712,-2443
502,"Coming Down the Mountain",1997,"https://www.youtube.com/embed/cYAtvv-wopk","https://encrypted-tbn0.gstatic.com/images?q=tbn:ANd9GcQhhglaTqXYejQ2b9TYl15F3E4pAgR1pWjyYyUTJgkHGuKsiWyHrw",43,7.2,6734,4020,2714,"Mauris enim leo, rhoncus sed, vestibulum sit amet, cursus id, turpis. Integer aliquet, massa id lobortis convallis, tortor risus dapibus augue, vel accumsan tellus nisi eu orci. Mauris lacinia sapien quis libero.",96,458,81,3.6,5954,218,5736
503,"AVPR: Aliens vs. Predator - Requiem",2009,"https://www.youtube.com/embed/Bn9iowpSWRs","https://i.pinimg.com/236x/5f/f6/69/5ff6693c3694f55e8ed9738084c4c6b1--d-design-design-concepts.jpg",65,2.1,7393,4020,3373,"Sed ante. Vivamus tortor. Duis mattis egestas metus.",86,2667,19,1.8,3624,2596,1028
504,"Breaking the Silence: Truth and Lies in the War on Terror",2001,"https://www.youtube.com/embed/c4O-c4OycPM","https://encrypted-tbn0.gstatic.com/images?q=tbn:ANd9GcTZmxe1lfZxGWCEdh5BIO8o0IWoInXoMB0QURL9yFrayrcsRK7J",26,7,5146,1822,3324,"Phasellus sit amet erat. Nulla tempus. Vivamus in felis eu sapien cursus vestibulum.",36,8363,26,2.4,5146,225,4921
505,"Zatoichi the Outlaw (Zatôichi rôyaburi) (Zatôichi 16)",1993,"https://www.youtube.com/embed/i6ilL5z6cjA","https://encrypted-tbn0.gstatic.com/images?q=tbn:ANd9GcSutU5UF40fwtxDcA61fL6VFTPKJYlaJOeUxSuI4qfpFQYO1KZ3",81,5.1,2269,6892,-4623,"Proin eu mi. Nulla ac enim. In tempor, turpis nec euismod scelerisque, quam turpis adipiscing lorem, vitae mattis nibh ligula nec sem.",82,1379,43,1.2,6175,6366,-191
506,"Protector (Protektor)",1994,"https://www.youtube.com/embed/yuYoFVHkvIA","https://encrypted-tbn0.gstatic.com/images?q=tbn:ANd9GcR_EXv1N1pkhMX0O3KAJXlTgC0_KL4WpSRDxUzH2CO9RPypuvxDAw",66,4.1,6175,1545,4630,"Quisque porta volutpat erat. Quisque erat eros, viverra eget, congue eget, semper rutrum, nulla. Nunc purus.",88,1379,25,7,1795,898,897
507,"The Poseidon Adventure",2010,"https://www.youtube.com/embed/COTt1zvBUJk","https://encrypted-tbn0.gstatic.com/images?q=tbn:ANd9GcSkP7ePajJciblvooQK7qTSV2J0ZdjBzPxrRi7NvBHdmOLYWeT4",7,1.8,1795,2777,-982,"Aenean lectus. Pellentesque eget nunc. Donec quis orci eget orci vehicula condimentum.",62,1948,2,9.6,2987,2308,679
508,"Isolation",2004,"https://www.youtube.com/embed/c4O-c4OycPM","https://encrypted-tbn0.gstatic.com/images?q=tbn:ANd9GcSabPrm9QL3aakFmkc9kWlHSQ9uzP10Yf493F57vDv3FicybY8YIg",62,9.5,6175,3563,2612,"In hac habitasse platea dictumst. Etiam faucibus cursus urna. Ut tellus.",54,281,56,3.2,4324,2308,2016
509,"Diary of a Shinjuku Thief (Shinjuku dorobo nikki)",1998,"https://www.youtube.com/embed/ee12SvnnrSw","https://encrypted-tbn0.gstatic.com/images?q=tbn:ANd9GcSigGMCEOHmqUMTkf9z3wcQTZlj2VM5cRueb-YgaX9_Hkej2qI5mQ",4,6,3605,2965,640,"Praesent id massa id nisl venenatis lacinia. Aenean sit amet justo. Morbi ut odio.",28,1115,66,6,9899,54,9845
510,"U2: Rattle and Hum",2004,"https://www.youtube.com/embed/MaI-4NepPfU","https://encrypted-tbn0.gstatic.com/images?q=tbn:ANd9GcRqaaKELSsRKJh2pc05f1s5ksCTCIa-bgxbzGUm2T7leAI2nlTqZw",56,3.2,4286,2001,2285,"Morbi non lectus. Aliquam sit amet diam in magna bibendum imperdiet. Nullam orci pede, venenatis non, sodales sed, tincidunt eu, felis.",58,6673,49,3.6,284,176,108
511,"The Paradine Case",2009,"https://www.youtube.com/embed/8oTXc5t35Ro","https://encrypted-tbn0.gstatic.com/images?q=tbn:ANd9GcRUlnvuLTJg0mT65nGxwZY6OfVvev6DxlvShy5w5Mpai-i6Vk6Qfg",34,7,2323,4124,-1801,"Praesent blandit. Nam nulla. Integer pede justo, lacinia eget, tincidunt eget, tempus vel, pede.",26,4828,49,9.6,5943,225,5718
512,"Little Giants",1996,"https://www.youtube.com/embed/6Ui6m_eEEOI","https://encrypted-tbn0.gstatic.com/images?q=tbn:ANd9GcQ3liTMd9u-FOh16V1KslqpsRMQ7s9_8wAeiIkai8222SoHyIRe",55,9.5,3923,1575,2348,"Phasellus sit amet erat. Nulla tempus. Vivamus in felis eu sapien cursus vestibulum.",40,7146,96,6.9,6006,5209,797
513,"Man Is Not a Bird (Covek nije tica)",1997,"https://www.youtube.com/embed/oNTzFnMXT3E","https://encrypted-tbn0.gstatic.com/images?q=tbn:ANd9GcSr9sVCqvsx-91eeqQvyCjpe4Fo7sap42UGJTn3IzdyIQVFy39R",40,3.2,8715,73,8642,"Curabitur in libero ut massa volutpat convallis. Morbi odio odio, elementum eu, interdum eu, tincidunt in, leo. Maecenas pulvinar lobortis est.",42,9382,70,9.3,7393,156,7237
514,"Digging Up the Marrow",1994,"https://www.youtube.com/embed/SF0w2B6DNUE","https://encrypted-tbn0.gstatic.com/images?q=tbn:ANd9GcRUlnvuLTJg0mT65nGxwZY6OfVvev6DxlvShy5w5Mpai-i6Vk6Qfg",90,7,6734,3539,3195,"Quisque porta volutpat erat. Quisque erat eros, viverra eget, congue eget, semper rutrum, nulla. Nunc purus.",52,8838,98,1.5,6175,1865,4310
515,"Hype!",1997,"https://www.youtube.com/embed/QJlh0IPQbbo","https://encrypted-tbn0.gstatic.com/images?q=tbn:ANd9GcQ1NxrNXukXKIzYZ8UbVazSnR-5741v5UDQPpMMVUvn_2I28fMZ",38,5.1,8388,1214,7174,"Proin leo odio, porttitor id, consequat in, consequat ut, nulla. Sed accumsan felis. Ut at dolor quis odio consequat varius.",52,8234,11,2.1,9696,4196,5500
516,"Card Subject To Change",1987,"https://www.youtube.com/embed/6W0KFTj50zI","https://encrypted-tbn0.gstatic.com/images?q=tbn:ANd9GcQ_K_OlRU89USb4Vi53WsTFwqiEXKhfRUVw08lWTiH5XSmSISDDwg",29,2.9,7393,4196,3197,"Nulla ut erat id mauris vulputate elementum. Nullam varius. Nulla facilisi.",26,735,94,4.3,118,6427,-6309
517,"Harry Potter and the Order of the Phoenix",1997,"https://www.youtube.com/embed/_aHDqS8EMn0","https://encrypted-tbn0.gstatic.com/images?q=tbn:ANd9GcRXW_MDHretVBvFBnfeqtLtE86uQkY-GTeOH_gP8OZY1Znu6a86qg",98,8.4,6275,1496,4779,"Cras mi pede, malesuada in, imperdiet et, commodo vulputate, justo. In blandit ultrices enim. Lorem ipsum dolor sit amet, consectetuer adipiscing elit.",50,2866,9,2,9822,5284,4538
518,"7 Women (a.k.a. Seven Women)",2010,"https://www.youtube.com/embed/G9T_f7DjYho","https://encrypted-tbn0.gstatic.com/images?q=tbn:ANd9GcSi9aOrS5oPJ7A3vLqJaEpNsmPCxVAYNwpoAl_G9K7p6pLBjaxALw",49,3.9,6469,3444,3025,"Aliquam quis turpis eget elit sodales scelerisque. Mauris sit amet eros. Suspendisse accumsan tortor quis turpis.",72,5258,10,3.2,1191,8629,-7438
519,"AVPR: Aliens vs. Predator - Requiem",2006,"https://www.youtube.com/embed/Sw_5YPAf7Zs","https://encrypted-tbn0.gstatic.com/images?q=tbn:ANd9GcSfdl_pNap7w4wYTP7dhiozrcmHAmCcADuvkKlsj19tBpxYkq60LA",81,3.8,6072,2596,3476,"Curabitur in libero ut massa volutpat convallis. Morbi odio odio, elementum eu, interdum eu, tincidunt in, leo. Maecenas pulvinar lobortis est.",86,281,59,4.2,6275,1983,4292
520,"Condorman",1994,"https://www.youtube.com/embed/HwWWws3kzKg","https://encrypted-tbn0.gstatic.com/images?q=tbn:ANd9GcSQ-QvEfMwKoUuWLDF2x2M1V4BTEN6-uoYrr8ShYvdSVQcHru6h",49,9.5,3458,781,2677,"Pellentesque at nulla. Suspendisse potenti. Cras in purus eu magna vulputate luctus.",80,9857,29,5.7,8816,2999,5817
521,"Aloft",1995,"https://www.youtube.com/embed/6SO96lvWqzc","https://encrypted-tbn0.gstatic.com/images?q=tbn:ANd9GcQ1NxrNXukXKIzYZ8UbVazSnR-5741v5UDQPpMMVUvn_2I28fMZ",25,6.8,132,5228,-5096,"Proin interdum mauris non ligula pellentesque ultrices. Phasellus id sapien in sapien iaculis congue. Vivamus metus arcu, adipiscing molestie, hendrerit at, vulputate vitae, nisl.",26,7121,50,6.9,6199,3527,2672
522,"Sky Fighters (Les Chevaliers Du Ciel)",1996,"https://www.youtube.com/embed/_aHDqS8EMn0","https://encrypted-tbn0.gstatic.com/images?q=tbn:ANd9GcT4OdTRV0WhSYFs5jcy1IZYf9s7DjJToLKAVXlTv4GhzQcgmD-C",42,8.1,5498,4124,1374,"Phasellus sit amet erat. Nulla tempus. Vivamus in felis eu sapien cursus vestibulum.",34,1379,26,3.2,284,2999,-2715
523,"Zatoichi the Outlaw (Zatôichi rôyaburi) (Zatôichi 16)",1997,"https://www.youtube.com/embed/LcepHRTWI18","https://encrypted-tbn0.gstatic.com/images?q=tbn:ANd9GcQ1aky5NsvfU2oObNVwH5j9ZHJNNcxRkRhHEYTh8yhtqNLPmxk0lA",70,8.9,3019,831,2188,"Suspendisse potenti. In eleifend quam a odio. In hac habitasse platea dictumst.",26,4907,6,8.8,7256,781,6475
524,"The Long Voyage Home",2005,"https://www.youtube.com/embed/DyQ8PoBV_Vo","https://encrypted-tbn0.gstatic.com/images?q=tbn:ANd9GcRboE_Oz4pmq_fbkSzc09GrZ6-FxQU9Zh64Y6b3LNLomLOlE4VEzQ",60,3.6,2987,1214,1773,"Morbi non lectus. Aliquam sit amet diam in magna bibendum imperdiet. Nullam orci pede, venenatis non, sodales sed, tincidunt eu, felis.",38,4897,19,1.7,5943,1374,4569
525,"Dr. Jekyll and Ms. Hyde",2010,"https://www.youtube.com/embed/LcepHRTWI18","https://encrypted-tbn0.gstatic.com/images?q=tbn:ANd9GcT8fsnqcp8Y3Y2dxkM4H8TJyS7bRYttijiNFZ-mruoqpzO29uM7",31,3.1,7162,923,6239,"Curabitur in libero ut massa volutpat convallis. Morbi odio odio, elementum eu, interdum eu, tincidunt in, leo. Maecenas pulvinar lobortis est.",88,7438,95,9.5,6386,6366,20
526,"Joe Kidd",2010,"https://www.youtube.com/embed/hgBj5b1TTDQ","https://encrypted-tbn0.gstatic.com/images?q=tbn:ANd9GcQ3liTMd9u-FOh16V1KslqpsRMQ7s9_8wAeiIkai8222SoHyIRe",62,4.9,8382,2777,5605,"Maecenas leo odio, condimentum id, luctus nec, molestie sed, justo. Pellentesque viverra pede ac diam. Cras pellentesque volutpat dui.",32,5410,36,1.4,3605,3412,193
527,"Barabbas",2005,"https://www.youtube.com/embed/7C2Nad0aMPg","https://encrypted-tbn0.gstatic.com/images?q=tbn:ANd9GcQ5LAO-oqK_jHF33R_asKWptHCRYc_456jcsgrngpU6q8htwl24",96,2.1,8611,1560,7051,"Curabitur at ipsum ac tellus semper interdum. Mauris ullamcorper purus sit amet nulla. Quisque arcu libero, rutrum ac, lobortis vel, dapibus at, diam.",36,8567,98,9,284,213,71
528,"Gorko!",1996,"https://www.youtube.com/embed/DIOW-kR_ams","https://encrypted-tbn0.gstatic.com/images?q=tbn:ANd9GcRTcG2_JqWMZJOf6uyZm7vI1GQGSsjWkKgxCokuA40pthaOj9LOFQ",96,3.4,3019,1741,1278,"Vestibulum ac est lacinia nisi venenatis tristique. Fusce congue, diam id ornare imperdiet, sapien urna pretium nisl, ut volutpat sapien arcu sed augue. Aliquam erat volutpat.",22,8039,28,2.4,8410,2198,6212
529,"Operation 'Y' & Other Shurik's Adventures",1993,"https://www.youtube.com/embed/6SO96lvWqzc","https://encrypted-tbn0.gstatic.com/images?q=tbn:ANd9GcQvfJ-vLQ5TK13ND8sY6H-r6cm_4f3SnW_WAWn2vuX-nGh6F8JquQ",4,5.9,6869,573,6296,"Maecenas tristique, est et tempus semper, est quam pharetra magna, ac consequat metus sapien ut nunc. Vestibulum ante ipsum primis in faucibus orci luctus et ultrices posuere cubilia Curae; Mauris viverra diam vitae quam. Suspendisse potenti.",40,6858,3,9.6,7715,2999,4716
530,"Poolboy: Drowning Out the Fury",2007,"https://www.youtube.com/embed/I7YdOosOjTU","https://encrypted-tbn0.gstatic.com/images?q=tbn:ANd9GcTt-58zOD-K4oKQ0AbvYduMdi-NxFRYLjx9Maf9ECQJMZkvfanqUw",22,3.4,3801,573,3228,"In hac habitasse platea dictumst. Etiam faucibus cursus urna. Ut tellus.",22,1631,95,6.2,9090,4125,4965
531,"Joe Kidd",2007,"https://www.youtube.com/embed/1ywA8TtwJ50","https://i.pinimg.com/736x/37/a0/99/37a099570abb65e478268af396315658--brochure-design-colour-combinations.jpg",49,1.8,6662,225,6437,"Quisque porta volutpat erat. Quisque erat eros, viverra eget, congue eget, semper rutrum, nulla. Nunc purus.",26,7146,68,6.9,6199,4712,1487
532,"Joe Kidd",2006,"https://www.youtube.com/embed/qSs5zsGoqs4","https://encrypted-tbn0.gstatic.com/images?q=tbn:ANd9GcSflOt4SdSx3LCTNP7im_XpsqHeeK_V_ltLPZEnK4mLjl4Eja_t",60,3.2,8454,2606,5848,"Praesent id massa id nisl venenatis lacinia. Aenean sit amet justo. Morbi ut odio.",64,4526,26,7.5,8388,1822,6566
533,"Breaking the Silence: Truth and Lies in the War on Terror",2010,"https://www.youtube.com/embed/6Ui6m_eEEOI","https://encrypted-tbn0.gstatic.com/images?q=tbn:ANd9GcQInYhbERWHKRlaq1eJAqZqaGQ9zndtpCyGofdPFToPGHuZUGCS",75,4.2,8454,5515,2939,"Cras non velit nec nisi vulputate nonummy. Maecenas tincidunt lacus at velit. Vivamus vel nulla eget eros elementum pellentesque.",50,1589,4,4.2,4324,1592,2732
534,"Sgt. Bilko",1994,"https://www.youtube.com/embed/IU3xV9ZRYlk","https://encrypted-tbn0.gstatic.com/images?q=tbn:ANd9GcSAeZgM34QBLW9W6aAQ7xBcJIa1KwtfVVcFHkKpsxvOjDBmNvh0",61,4.3,8377,176,8201,"Integer tincidunt ante vel ipsum. Praesent blandit lacinia erat. Vestibulum sed magna at nunc commodo placerat.",58,2476,38,2.1,8496,573,7923
535,"Second Wind (Le deuxième souffle) (Second Breath)",2012,"https://www.youtube.com/embed/DyQ8PoBV_Vo","https://encrypted-tbn0.gstatic.com/images?q=tbn:ANd9GcRfaybDSA3hF-btWMAObj0lbtp7UbFPvvC41dZ9EEL1BMISwxF6",90,5.1,7890,5471,2419,"Pellentesque at nulla. Suspendisse potenti. Cras in purus eu magna vulputate luctus.",66,4252,55,4.2,5943,5206,737
536,"Man Is Not a Bird (Covek nije tica)",1996,"https://www.youtube.com/embed/MNp1LPm3Krs","https://encrypted-tbn0.gstatic.com/images?q=tbn:ANd9GcSmZDfgAQh9gNhDHM4YtECFcKd6iXDTMrn-PXI6Wylc9Lddn5ah-w",83,7,3458,3428,30,"Mauris enim leo, rhoncus sed, vestibulum sit amet, cursus id, turpis. Integer aliquet, massa id lobortis convallis, tortor risus dapibus augue, vel accumsan tellus nisi eu orci. Mauris lacinia sapien quis libero.",98,7498,9,4.1,284,1025,-741
537,"The Big Trail",2005,"https://www.youtube.com/embed/c4O-c4OycPM","https://encrypted-tbn0.gstatic.com/images?q=tbn:ANd9GcQLt0-lz7NK5w-_elA1XCxyK77lQX2-JBVeEkkOx2aJ8RjYYqE4Vw",34,1,3411,1374,2037,"Praesent blandit. Nam nulla. Integer pede justo, lacinia eget, tincidunt eget, tempus vel, pede.",44,3444,28,8.3,6469,2999,3470
538,"U2: Rattle and Hum",1999,"https://www.youtube.com/embed/2BoyDp49C6Y","https://encrypted-tbn0.gstatic.com/images?q=tbn:ANd9GcRyMl7AW_r-FXiuqUSSUA5Mww484NZ8QAd_-vEbcfX2bB8j-uCn1g",31,2.4,3417,9584,-6167,"Sed ante. Vivamus tortor. Duis mattis egestas metus.",30,2866,19,6.8,3801,47,3754
539,"The Living Magoroku",2007,"https://www.youtube.com/embed/nMVDQZ34joY","https://encrypted-tbn0.gstatic.com/images?q=tbn:ANd9GcSr9sVCqvsx-91eeqQvyCjpe4Fo7sap42UGJTn3IzdyIQVFy39R",20,3.8,8496,3444,5052,"Proin leo odio, porttitor id, consequat in, consequat ut, nulla. Sed accumsan felis. Ut at dolor quis odio consequat varius.",26,510,49,8.1,6734,3371,3363
540,"Bullet",2011,"https://www.youtube.com/embed/6W0KFTj50zI","https://encrypted-tbn0.gstatic.com/images?q=tbn:ANd9GcTppyYABMyqegOc4I6b3NS0iUaX0R6Cy1-PlahMrPPUzzqPNux9Gg",29,6.8,8388,156,8232,"Cras mi pede, malesuada in, imperdiet et, commodo vulputate, justo. In blandit ultrices enim. Lorem ipsum dolor sit amet, consectetuer adipiscing elit.",62,1631,49,3.1,118,5284,-5166
541,"Poolboy: Drowning Out the Fury",2010,"https://www.youtube.com/embed/COTt1zvBUJk","https://encrypted-tbn0.gstatic.com/images?q=tbn:ANd9GcRauFfIne8mHbF9MCn-LxY8C6gHqalPefcj6s8z0B9JZwEnD5A4",77,1.8,6386,1741,4645,"Cum sociis natoque penatibus et magnis dis parturient montes, nascetur ridiculus mus. Vivamus vestibulum sagittis sapien. Cum sociis natoque penatibus et magnis dis parturient montes, nascetur ridiculus mus.",88,2435,95,3.4,9585,2617,6968
542,"Fido",2009,"https://www.youtube.com/embed/6SO96lvWqzc","https://encrypted-tbn0.gstatic.com/images?q=tbn:ANd9GcRUlnvuLTJg0mT65nGxwZY6OfVvev6DxlvShy5w5Mpai-i6Vk6Qfg",70,1.7,9416,3428,5988,"Proin leo odio, porttitor id, consequat in, consequat ut, nulla. Sed accumsan felis. Ut at dolor quis odio consequat varius.",80,25,36,1.5,2323,213,2110
543,"Little Nikita",2001,"https://www.youtube.com/embed/SF0w2B6DNUE","https://encrypted-tbn0.gstatic.com/images?q=tbn:ANd9GcRfaybDSA3hF-btWMAObj0lbtp7UbFPvvC41dZ9EEL1BMISwxF6",37,7.8,6469,3607,2862,"Fusce posuere felis sed lacus. Morbi sem mauris, laoreet ut, rhoncus aliquet, pulvinar sed, nisl. Nunc rhoncus dui vel sem.",24,9441,38,1.8,6774,3527,3247
544,"Fair Game",1968,"https://www.youtube.com/embed/fkr_djVWStU","https://encrypted-tbn0.gstatic.com/images?q=tbn:ANd9GcSutU5UF40fwtxDcA61fL6VFTPKJYlaJOeUxSuI4qfpFQYO1KZ3",37,4.8,6734,627,6107,"In sagittis dui vel nisl. Duis ac nibh. Fusce lacus purus, aliquet at, feugiat non, pretium quis, lectus.",54,4185,13,7,2777,1037,1740
545,"The Gaucho",1994,"https://www.youtube.com/embed/Xwzwmc2AZYg","https://encrypted-tbn0.gstatic.com/images?q=tbn:ANd9GcSigGMCEOHmqUMTkf9z3wcQTZlj2VM5cRueb-YgaX9_Hkej2qI5mQ",81,8.8,9899,215,9684,"Nam ultrices, libero non mattis pulvinar, nulla pede ullamcorper augue, a suscipit nulla elit ac nulla. Sed vel enim sit amet nunc viverra dapibus. Nulla suscipit ligula in lacus.",96,1442,75,6,9496,1590,7906
546,"Elvis Meets Nixon",1989,"https://www.youtube.com/embed/_c3WIprIGHE","https://encrypted-tbn0.gstatic.com/images?q=tbn:ANd9GcRZ2qgbwUkZMB6Z3KUBla8OIzYNOBzMaNpoAeNofRYZj8V27vwD",78,5.1,118,1741,-1623,"Aenean lectus. Pellentesque eget nunc. Donec quis orci eget orci vehicula condimentum.",70,9683,37,1.5,5541,2999,2542
547,"The Long Voyage Home",1992,"https://www.youtube.com/embed/wKvOud9GcRQ","https://encrypted-tbn0.gstatic.com/images?q=tbn:ANd9GcRfaybDSA3hF-btWMAObj0lbtp7UbFPvvC41dZ9EEL1BMISwxF6",88,9.3,6469,7219,-750,"Integer tincidunt ante vel ipsum. Praesent blandit lacinia erat. Vestibulum sed magna at nunc commodo placerat.",30,9857,62,9.7,9090,5228,3862
548,"Little Nikita",2000,"https://www.youtube.com/embed/keo8PJecIEc","https://images-na.ssl-images-amazon.com/images/I/41SFojuU1FL._SY600_.jpg",49,9,7890,3428,4462,"Integer tincidunt ante vel ipsum. Praesent blandit lacinia erat. Vestibulum sed magna at nunc commodo placerat.",40,458,45,6.8,5954,4860,1094
549,"Jin Roh: The Wolf Brigade (Jin-Rô)",2012,"https://www.youtube.com/embed/MExr5cmGsC4","https://encrypted-tbn0.gstatic.com/images?q=tbn:ANd9GcTVx6QbLHPUKkVSj1TkaOANhnRfjtIXHhKnHSaIR2y3RkCgry-X",31,6.3,7762,7462,300,"Fusce consequat. Nulla nisl. Nunc nisl.",62,9431,19,1.8,1360,1374,-14
550,"U2: Rattle and Hum",2011,"https://www.youtube.com/embed/78ozCL4sQoI","https://encrypted-tbn0.gstatic.com/images?q=tbn:ANd9GcR203qZ3CqJHkReGO_urfLpOmRqqwbZ6g8ZOVV-2aZbySbWl_abdg",69,1,3801,4020,-219,"Maecenas tristique, est et tempus semper, est quam pharetra magna, ac consequat metus sapien ut nunc. Vestibulum ante ipsum primis in faucibus orci luctus et ultrices posuere cubilia Curae; Mauris viverra diam vitae quam. Suspendisse potenti.",26,694,20,5.9,6386,176,6210
551,"Edmond",2009,"https://www.youtube.com/embed/ee1172yeqyE","https://encrypted-tbn0.gstatic.com/images?q=tbn:ANd9GcSnUCe3jwoe6TiIdg0tv_j25Q3WHNDjeBfzqlYhOl70hy95_k9t1Q",9,8.1,1795,4712,-2917,"Maecenas leo odio, condimentum id, luctus nec, molestie sed, justo. Pellentesque viverra pede ac diam. Cras pellentesque volutpat dui.",96,4799,50,2.4,5704,263,5441
552,"Operation 'Y' & Other Shurik's Adventures",2004,"https://www.youtube.com/embed/8oTXc5t35Ro","https://encrypted-tbn0.gstatic.com/images?q=tbn:ANd9GcSnUCe3jwoe6TiIdg0tv_j25Q3WHNDjeBfzqlYhOl70hy95_k9t1Q",66,2.4,8429,3444,4985,"Proin interdum mauris non ligula pellentesque ultrices. Phasellus id sapien in sapien iaculis congue. Vivamus metus arcu, adipiscing molestie, hendrerit at, vulputate vitae, nisl.",68,4091,23,1.8,8715,3648,5067
553,"Clifford",1997,"https://www.youtube.com/embed/6SO96lvWqzc","https://encrypted-tbn0.gstatic.com/images?q=tbn:ANd9GcR6OdK3cVIVUn07PmO7zFQb1JyTfdi6L4FwxFWOD9dfwTwN4hEt",98,2.1,9122,218,8904,"Integer ac leo. Pellentesque ultrices mattis odio. Donec vitae nisi.",40,6632,96,6.7,7383,5284,2099
554,"The Last Seduction",2000,"https://www.youtube.com/embed/dfUJm6XgD7g","https://encrypted-tbn0.gstatic.com/images?q=tbn:ANd9GcRUlnvuLTJg0mT65nGxwZY6OfVvev6DxlvShy5w5Mpai-i6Vk6Qfg",95,5.1,9994,6494,3500,"Proin leo odio, porttitor id, consequat in, consequat ut, nulla. Sed accumsan felis. Ut at dolor quis odio consequat varius.",70,1379,65,3.1,12,5515,-5503
555,"Holy Flame of the Martial World (Wu lin sheng huo jin)",2002,"https://www.youtube.com/embed/fkr_djVWStU","https://encrypted-tbn0.gstatic.com/images?q=tbn:ANd9GcQj3o8UxHr9-tOcX5N5ppAE1Y9EZS5-9IYjKEogAzmsetJB5g0w",28,6.8,692,2198,-1506,"Aliquam quis turpis eget elit sodales scelerisque. Mauris sit amet eros. Suspendisse accumsan tortor quis turpis.",26,2866,81,9.3,4602,772,3830
556,"Iceberg, L'",2006,"https://www.youtube.com/embed/MpJEOpsVWtA","https://encrypted-tbn0.gstatic.com/images?q=tbn:ANd9GcS_NoH0Aw_5YFsBFwfBPn_O7YPHXumI5V3iQ2s7B-3zPU_7sSm1gA",64,4.1,6774,2606,4168,"Sed ante. Vivamus tortor. Duis mattis egestas metus.",74,735,6,2,6755,537,6218
557,"Hardcore",2007,"https://www.youtube.com/embed/oP-fRX_gB6o","https://encrypted-tbn0.gstatic.com/images?q=tbn:ANd9GcQaa7JH1TX7xtU8SpR35IjPOWF7HSujPYnfqJy-FlHEfxv6HXq3tQ",95,2,6755,2606,4149,"Proin eu mi. Nulla ac enim. In tempor, turpis nec euismod scelerisque, quam turpis adipiscing lorem, vitae mattis nibh ligula nec sem.",86,5537,42,7,5146,8629,-3483
558,"Azumi 2: Death or Love",2006,"https://www.youtube.com/embed/YoBOCxBq88A","https://encrypted-tbn0.gstatic.com/images?q=tbn:ANd9GcTiS27rf1ltLwxOAbTBhYvqJuvJG8ctIALtoknQh7MHlvV3r0UO",44,9.3,6386,3118,3268,"Pellentesque at nulla. Suspendisse potenti. Cras in purus eu magna vulputate luctus.",48,1649,26,1.5,3923,1504,2419
559,"The Living Magoroku",2001,"https://www.youtube.com/embed/EKGATzNnr8c","https://encrypted-tbn0.gstatic.com/images?q=tbn:ANd9GcRyMl7AW_r-FXiuqUSSUA5Mww484NZ8QAd_-vEbcfX2bB8j-uCn1g",33,2,4286,3648,638,"Cras non velit nec nisi vulputate nonummy. Maecenas tincidunt lacus at velit. Vivamus vel nulla eget eros elementum pellentesque.",28,6673,42,6.8,7146,2606,4540
560,"The Land Before Time XII: The Great Day of the Flyers",2005,"https://www.youtube.com/embed/7C2Nad0aMPg","https://encrypted-tbn0.gstatic.com/images?q=tbn:ANd9GcRTcG2_JqWMZJOf6uyZm7vI1GQGSsjWkKgxCokuA40pthaOj9LOFQ",95,6.8,6275,213,6062,"Nulla ut erat id mauris vulputate elementum. Nullam varius. Nulla facilisi.",74,2866,24,5.1,8377,1592,6785
561,"Little Nikita",2011,"https://www.youtube.com/embed/78ozCL4sQoI","https://encrypted-tbn0.gstatic.com/images?q=tbn:ANd9GcQvfJ-vLQ5TK13ND8sY6H-r6cm_4f3SnW_WAWn2vuX-nGh6F8JquQ",4,3.2,8611,5206,3405,"Aenean lectus. Pellentesque eget nunc. Donec quis orci eget orci vehicula condimentum.",50,2840,22,9.3,8377,1214,7163
562,"Sky Fighters (Les Chevaliers Du Ciel)",1999,"https://www.youtube.com/embed/QJlh0IPQbbo","https://encrypted-tbn0.gstatic.com/images?q=tbn:ANd9GcT5qYZ7WL1XpLSuZms35fvGdxwAwN8ZoDje7zRyyFHfFSsWWAHelQ",26,5.1,3923,781,3142,"Cras mi pede, malesuada in, imperdiet et, commodo vulputate, justo. In blandit ultrices enim. Lorem ipsum dolor sit amet, consectetuer adipiscing elit.",62,5002,68,7,5146,3251,1895
563,"Second Wind (Le deuxième souffle) (Second Breath)",2005,"https://www.youtube.com/embed/ee12SvnnrSw","https://encrypted-tbn0.gstatic.com/images?q=tbn:ANd9GcSJJAS-aY5yM_o538SFwYJKMI1ICZvCAEdnVZX59tINRulVx7aBpA",42,1.1,8816,4020,4796,"Integer tincidunt ante vel ipsum. Praesent blandit lacinia erat. Vestibulum sed magna at nunc commodo placerat.",80,4252,70,6.1,6175,2999,3176
564,"Another Woman",1999,"https://www.youtube.com/embed/MExr5cmGsC4","https://images-na.ssl-images-amazon.com/images/I/41SFojuU1FL._SY600_.jpg",70,6.3,5542,3251,2291,"Nulla ut erat id mauris vulputate elementum. Nullam varius. Nulla facilisi.",60,6858,33,9.7,5954,831,5123
565,"U2: Rattle and Hum",1985,"https://www.youtube.com/embed/fPq4zW9QZSg","https://encrypted-tbn0.gstatic.com/images?q=tbn:ANd9GcT11kibbY7ZQKvhvKatIRRKfv-n-n77Ve-QuVdMOoMg-fol_k9j",36,7,1795,3421,-1626,"Donec diam neque, vestibulum eget, vulputate ut, ultrices vel, augue. Vestibulum ante ipsum primis in faucibus orci luctus et ultrices posuere cubilia Curae; Donec pharetra, magna vestibulum aliquet ultrices, erat tortor sollicitudin mi, sit amet lobortis sapien sapien non mi. Integer ac neque.",60,2840,38,7.5,7383,5228,2155
566,"The Paradine Case",1989,"https://www.youtube.com/embed/nMVDQZ34joY","https://encrypted-tbn0.gstatic.com/images?q=tbn:ANd9GcQzrbGfcJ8GKN78hn-r1fcQf4zH81e0MlsuOddkBJvhC5RvfF2DNw",78,8.1,9683,1898,7785,"Vestibulum ac est lacinia nisi venenatis tristique. Fusce congue, diam id ornare imperdiet, sapien urna pretium nisl, ut volutpat sapien arcu sed augue. Aliquam erat volutpat.",36,458,40,5.1,9389,2596,6793
567,"The Iran Job",2006,"https://www.youtube.com/embed/BQcvHEkGaEA","https://encrypted-tbn0.gstatic.com/images?q=tbn:ANd9GcSaZZLwGXqiNU5rkhexU86wKZGzymZWTp2nKRDFdITh7rD7Jb6yGA",31,1.7,3801,8964,-5163,"Cum sociis natoque penatibus et magnis dis parturient montes, nascetur ridiculus mus. Vivamus vestibulum sagittis sapien. Cum sociis natoque penatibus et magnis dis parturient montes, nascetur ridiculus mus.",28,2822,24,8.9,3923,1575,2348
568,"Harry Potter and the Order of the Phoenix",2010,"https://www.youtube.com/embed/dfUJm6XgD7g","https://encrypted-tbn0.gstatic.com/images?q=tbn:ANd9GcSJJAS-aY5yM_o538SFwYJKMI1ICZvCAEdnVZX59tINRulVx7aBpA",66,6.2,9585,6554,3031,"Donec diam neque, vestibulum eget, vulputate ut, ultrices vel, augue. Vestibulum ante ipsum primis in faucibus orci luctus et ultrices posuere cubilia Curae; Donec pharetra, magna vestibulum aliquet ultrices, erat tortor sollicitudin mi, sit amet lobortis sapien sapien non mi. Integer ac neque.",56,9178,70,5.7,2016,4196,-2180
569,"Rabid Grannies (Mémés cannibales, Les)",2011,"https://www.youtube.com/embed/9gWsyEkKO1A","https://encrypted-tbn0.gstatic.com/images?q=tbn:ANd9GcRfaybDSA3hF-btWMAObj0lbtp7UbFPvvC41dZ9EEL1BMISwxF6",77,6.8,6755,3313,3442,"Integer ac leo. Pellentesque ultrices mattis odio. Donec vitae nisi.",96,1317,28,9.3,8611,3251,5360
570,"Man Is Not a Bird (Covek nije tica)",1994,"https://www.youtube.com/embed/Sw_5YPAf7Zs","https://encrypted-tbn0.gstatic.com/images?q=tbn:ANd9GcTrBuPeRIXbqvHjWMwFg1aZvVkw71rsNVla5A067w7kiY-DPB7N",80,6.2,2733,6885,-4152,"In quis justo. Maecenas rhoncus aliquam lacus. Morbi quis tortor id nulla ultrices aliquet.",38,1317,42,5.7,2987,73,2914
571,"Dorado, El",2010,"https://www.youtube.com/embed/dfUJm6XgD7g","https://encrypted-tbn0.gstatic.com/images?q=tbn:ANd9GcRboE_Oz4pmq_fbkSzc09GrZ6-FxQU9Zh64Y6b3LNLomLOlE4VEzQ",38,5.9,2883,6494,-3611,"Integer tincidunt ante vel ipsum. Praesent blandit lacinia erat. Vestibulum sed magna at nunc commodo placerat.",70,735,57,2.4,12,2777,-2765
572,"All These Women (För att inte tala om alla dessa kvinnor)",2005,"https://www.youtube.com/embed/7C2Nad0aMPg","https://i.pinimg.com/736x/37/a0/99/37a099570abb65e478268af396315658--brochure-design-colour-combinations.jpg",65,3.4,6801,4196,2605,"Aenean lectus. Pellentesque eget nunc. Donec quis orci eget orci vehicula condimentum.",70,1649,98,4.2,1191,3313,-2122
573,"Lust for Gold",2011,"https://www.youtube.com/embed/sZ8e_0i7UDk","https://encrypted-tbn0.gstatic.com/images?q=tbn:ANd9GcTlHaTq59e08Zugqn9ZX71XQYUOtuUGEQ9Mkl_HR1NmuSBceL7O",26,9,7715,1592,6123,"Donec diam neque, vestibulum eget, vulputate ut, ultrices vel, augue. Vestibulum ante ipsum primis in faucibus orci luctus et ultrices posuere cubilia Curae; Donec pharetra, magna vestibulum aliquet ultrices, erat tortor sollicitudin mi, sit amet lobortis sapien sapien non mi. Integer ac neque.",96,8851,48,7.7,7683,2489,5194
574,"The Law of the Weakest",1986,"https://www.youtube.com/embed/_c3WIprIGHE","https://encrypted-tbn0.gstatic.com/images?q=tbn:ANd9GcToWUNrpDN1sKiQrTBrAPVZaaHkjYWkdwsMh5Igburh2w20IPRs",3,7,6755,573,6182,"Sed ante. Vivamus tortor. Duis mattis egestas metus.",62,8851,84,8.3,7683,2606,5077
575,"Aloft",2002,"https://www.youtube.com/embed/2FbDY0MeJf8","https://encrypted-tbn0.gstatic.com/images?q=tbn:ANd9GcSRkE8RSex-89LA2Msfb1Vq6eH047lvDYppmp9IwK2zLgw2nbE-Uw",31,9,3801,2965,836,"Mauris enim leo, rhoncus sed, vestibulum sit amet, cursus id, turpis. Integer aliquet, massa id lobortis convallis, tortor risus dapibus augue, vel accumsan tellus nisi eu orci. Mauris lacinia sapien quis libero.",68,962,56,5.1,5954,2352,3602
576,"Murder Ahoy",2001,"https://www.youtube.com/embed/cYAtvv-wopk","https://encrypted-tbn0.gstatic.com/images?q=tbn:ANd9GcQ1NxrNXukXKIzYZ8UbVazSnR-5741v5UDQPpMMVUvn_2I28fMZ",70,6,6579,3444,3135,"Donec diam neque, vestibulum eget, vulputate ut, ultrices vel, augue. Vestibulum ante ipsum primis in faucibus orci luctus et ultrices posuere cubilia Curae; Donec pharetra, magna vestibulum aliquet ultrices, erat tortor sollicitudin mi, sit amet lobortis sapien sapien non mi. Integer ac neque.",98,7702,94,2.8,5704,1214,4490
577,"Holy Flame of the Martial World (Wu lin sheng huo jin)",2000,"https://www.youtube.com/embed/eAIjuMHKEiA","https://encrypted-tbn0.gstatic.com/images?q=tbn:ANd9GcRZ2qgbwUkZMB6Z3KUBla8OIzYNOBzMaNpoAeNofRYZj8V27vwD",34,3.2,7256,3118,4138,"Praesent blandit. Nam nulla. Integer pede justo, lacinia eget, tincidunt eget, tempus vel, pede.",30,9857,90,1.2,5704,6427,-723
578,"When Time Ran Out...",1996,"https://www.youtube.com/embed/PdL8kn_G5EQ","https://encrypted-tbn0.gstatic.com/images?q=tbn:ANd9GcR203qZ3CqJHkReGO_urfLpOmRqqwbZ6g8ZOVV-2aZbySbWl_abdg",26,3.4,6801,1025,5776,"Donec diam neque, vestibulum eget, vulputate ut, ultrices vel, augue. Vestibulum ante ipsum primis in faucibus orci luctus et ultrices posuere cubilia Curae; Donec pharetra, magna vestibulum aliquet ultrices, erat tortor sollicitudin mi, sit amet lobortis sapien sapien non mi. Integer ac neque.",50,2789,70,6.8,3923,54,3869
579,"The Cell 2",2001,"https://www.youtube.com/embed/iaM3y7uDL90","https://encrypted-tbn0.gstatic.com/images?q=tbn:ANd9GcSH9tC-osjnxukCMxARZTOlLqboCFbGakXL0EtWmcFdJO1wQL38",70,6.9,2269,627,1642,"Aliquam quis turpis eget elit sodales scelerisque. Mauris sit amet eros. Suspendisse accumsan tortor quis turpis.",56,4869,66,5.7,3411,2352,1059
580,"Diary of a Shinjuku Thief (Shinjuku dorobo nikki)",2011,"https://www.youtube.com/embed/Xwzwmc2AZYg","https://encrypted-tbn0.gstatic.com/images?q=tbn:ANd9GcSkjHflFbGJwA3Dk6FW71ynZ5C6z_y9dkcX7Q0Q-2NSkRIUerlH",6,3.6,5542,3428,2114,"Proin eu mi. Nulla ac enim. In tempor, turpis nec euismod scelerisque, quam turpis adipiscing lorem, vitae mattis nibh ligula nec sem.",64,7146,96,1,8388,7462,926
581,"Barabbas",1997,"https://www.youtube.com/embed/dfUJm6XgD7g","https://encrypted-tbn0.gstatic.com/images?q=tbn:ANd9GcRyMl7AW_r-FXiuqUSSUA5Mww484NZ8QAd_-vEbcfX2bB8j-uCn1g",83,8.1,8715,831,7884,"In hac habitasse platea dictumst. Etiam faucibus cursus urna. Ut tellus.",80,6113,13,5.9,9585,781,8804
582,"The Possession of Michael King",1987,"https://www.youtube.com/embed/iW3t_wUDG5U","https://encrypted-tbn0.gstatic.com/images?q=tbn:ANd9GcSQ-QvEfMwKoUuWLDF2x2M1V4BTEN6-uoYrr8ShYvdSVQcHru6h",70,2.1,8715,3881,4834,"Fusce consequat. Nulla nisl. Nunc nisl.",26,6139,22,8.9,5498,1545,3953
583,"Man Is Not a Bird (Covek nije tica)",1999,"https://www.youtube.com/embed/iOMxsy8S7hk","https://encrypted-tbn0.gstatic.com/images?q=tbn:ANd9GcQaa7JH1TX7xtU8SpR35IjPOWF7HSujPYnfqJy-FlHEfxv6HXq3tQ",69,8.9,198,1733,-1535,"Aliquam quis turpis eget elit sodales scelerisque. Mauris sit amet eros. Suspendisse accumsan tortor quis turpis.",100,6139,41,9.7,5529,6885,-1356
584,"People Will Talk",1998,"https://www.youtube.com/embed/7C2Nad0aMPg","https://encrypted-tbn0.gstatic.com/images?q=tbn:ANd9GcRUMZIkgEW4ZtYyXTgo6uGdYksy7dreOkd-zJRc1uGna-GAnU3SDQ",98,8.3,6072,2777,3295,"Fusce consequat. Nulla nisl. Nunc nisl.",40,1317,55,9,1795,5284,-3489
585,"The Cell 2",1979,"https://www.youtube.com/embed/HwWWws3kzKg","https://encrypted-tbn0.gstatic.com/images?q=tbn:ANd9GcR_EXv1N1pkhMX0O3KAJXlTgC0_KL4WpSRDxUzH2CO9RPypuvxDAw",28,1.2,8437,923,7514,"Duis aliquam convallis nunc. Proin at turpis a pede posuere nonummy. Integer non velit.",22,8647,31,3.2,6755,3371,3384
586,"Operation 'Y' & Other Shurik's Adventures",1989,"https://www.youtube.com/embed/B12REtkl2KY","https://encrypted-tbn0.gstatic.com/images?q=tbn:ANd9GcSfdl_pNap7w4wYTP7dhiozrcmHAmCcADuvkKlsj19tBpxYkq60LA",38,6.9,9822,6366,3456,"Pellentesque at nulla. Suspendisse potenti. Cras in purus eu magna vulputate luctus.",44,5615,81,1.8,8611,5209,3402
587,"The Iran Job",2012,"https://www.youtube.com/embed/B12REtkl2KY","https://encrypted-tbn0.gstatic.com/images?q=tbn:ANd9GcSkjHflFbGJwA3Dk6FW71ynZ5C6z_y9dkcX7Q0Q-2NSkRIUerlH",4,1.1,2777,1741,1036,"Lorem ipsum dolor sit amet, consectetuer adipiscing elit. Proin risus. Praesent lectus.",26,1882,19,1,7890,562,7328
588,"The Land Before Time XII: The Great Day of the Flyers",1996,"https://www.youtube.com/embed/cYAtvv-wopk","https://encrypted-tbn0.gstatic.com/images?q=tbn:ANd9GcTiS27rf1ltLwxOAbTBhYvqJuvJG8ctIALtoknQh7MHlvV3r0UO",80,5.1,5943,6427,-484,"Pellentesque at nulla. Suspendisse potenti. Cras in purus eu magna vulputate luctus.",26,8546,22,7,5160,6885,-1725
589,"The King",2001,"https://www.youtube.com/embed/eqDHqOcXjRQ","https://encrypted-tbn0.gstatic.com/images?q=tbn:ANd9GcSfenuQRjGbddBAE4j3I_GN73Ch-EI9uairOfxWWbLQYAluLoDWCQ",64,7.7,8377,8004,373,"Donec diam neque, vestibulum eget, vulputate ut, ultrices vel, augue. Vestibulum ante ipsum primis in faucibus orci luctus et ultrices posuere cubilia Curae; Donec pharetra, magna vestibulum aliquet ultrices, erat tortor sollicitudin mi, sit amet lobortis sapien sapien non mi. Integer ac neque.",52,7121,25,1,9496,7219,2277
590,"Zatoichi the Outlaw (Zatôichi rôyaburi) (Zatôichi 16)",1987,"https://www.youtube.com/embed/LcepHRTWI18","https://encrypted-tbn0.gstatic.com/images?q=tbn:ANd9GcTt-58zOD-K4oKQ0AbvYduMdi-NxFRYLjx9Maf9ECQJMZkvfanqUw",11,4.9,8496,537,7959,"Proin interdum mauris non ligula pellentesque ultrices. Phasellus id sapien in sapien iaculis congue. Vivamus metus arcu, adipiscing molestie, hendrerit at, vulputate vitae, nisl.",30,6858,57,1.2,5943,5228,715
591,"Hardcore",2003,"https://www.youtube.com/embed/l-u3PdA-rpY","https://encrypted-tbn0.gstatic.com/images?q=tbn:ANd9GcRxLYJSuzc9AAuuJ3R1HulbKM_T8_whdwPZQj7VyYonHOME6fYq",96,2.9,7146,176,6970,"Phasellus sit amet erat. Nulla tempus. Vivamus in felis eu sapien cursus vestibulum.",44,4828,96,1.1,3411,7462,-4051
592,"Fido",1984,"https://www.youtube.com/embed/LcepHRTWI18","https://encrypted-tbn0.gstatic.com/images?q=tbn:ANd9GcT8fsnqcp8Y3Y2dxkM4H8TJyS7bRYttijiNFZ-mruoqpzO29uM7",49,1.8,132,5228,-5096,"Nulla ut erat id mauris vulputate elementum. Nullam varius. Nulla facilisi.",96,9282,77,8.1,8410,1061,7349
593,"The Land Before Time XII: The Great Day of the Flyers",2009,"https://www.youtube.com/embed/G9T_f7DjYho","https://encrypted-tbn0.gstatic.com/images?q=tbn:ANd9GcQ1RC08Lpg31X2H7K5Uphlh7PGrzq7-JtVNzeSh-4UIh-JZbUaCDg",95,2.1,9416,156,9260,"Vestibulum ac est lacinia nisi venenatis tristique. Fusce congue, diam id ornare imperdiet, sapien urna pretium nisl, ut volutpat sapien arcu sed augue. Aliquam erat volutpat.",30,7690,35,6.8,5541,562,4979
594,"The Stars Fell on Henrietta",2009,"https://www.youtube.com/embed/fkr_djVWStU","https://encrypted-tbn0.gstatic.com/images?q=tbn:ANd9GcSQ-QvEfMwKoUuWLDF2x2M1V4BTEN6-uoYrr8ShYvdSVQcHru6h",65,9.1,6199,47,6152,"Proin eu mi. Nulla ac enim. In tempor, turpis nec euismod scelerisque, quam turpis adipiscing lorem, vitae mattis nibh ligula nec sem.",50,3441,7,2.4,6072,3771,2301
595,"Of Love and Shadows",1997,"https://www.youtube.com/embed/ka3J1sUhQ4M","https://encrypted-tbn0.gstatic.com/images?q=tbn:ANd9GcRxLYJSuzc9AAuuJ3R1HulbKM_T8_whdwPZQj7VyYonHOME6fYq",45,6,6662,2965,3697,"Cras mi pede, malesuada in, imperdiet et, commodo vulputate, justo. In blandit ultrices enim. Lorem ipsum dolor sit amet, consectetuer adipiscing elit.",62,9683,80,5.1,8454,1037,7417
596,"When Time Ran Out...",1999,"https://www.youtube.com/embed/8oTXc5t35Ro","https://encrypted-tbn0.gstatic.com/images?q=tbn:ANd9GcTpzv6ZkKQ_5fFlx242_ZFGnV3MuzyUBrlVMhbcTFBKJGCr7XxS",19,2.8,8382,73,8309,"Cras non velit nec nisi vulputate nonummy. Maecenas tincidunt lacus at velit. Vivamus vel nulla eget eros elementum pellentesque.",80,6719,95,1.2,753,3074,-2321
597,"Operation 'Y' & Other Shurik's Adventures",1996,"https://www.youtube.com/embed/B12REtkl2KY","https://encrypted-tbn0.gstatic.com/images?q=tbn:ANd9GcTZmxe1lfZxGWCEdh5BIO8o0IWoInXoMB0QURL9yFrayrcsRK7J",31,5.4,6006,2198,3808,"Duis aliquam convallis nunc. Proin at turpis a pede posuere nonummy. Integer non velit.",58,8065,61,5.9,8301,6885,1416
598,"Confidence",1985,"https://www.youtube.com/embed/nMVDQZ34joY","https://encrypted-tbn0.gstatic.com/images?q=tbn:ANd9GcSRkE8RSex-89LA2Msfb1Vq6eH047lvDYppmp9IwK2zLgw2nbE-Uw",87,1.5,9389,3607,5782,"Proin eu mi. Nulla ac enim. In tempor, turpis nec euismod scelerisque, quam turpis adipiscing lorem, vitae mattis nibh ligula nec sem.",38,7146,6,8.3,8382,2596,5786
599,"Zatoichi the Outlaw (Zatôichi rôyaburi) (Zatôichi 16)",2010,"https://www.youtube.com/embed/c4O-c4OycPM","https://encrypted-tbn0.gstatic.com/images?q=tbn:ANd9GcTppyYABMyqegOc4I6b3NS0iUaX0R6Cy1-PlahMrPPUzzqPNux9Gg",20,4.9,2779,6892,-4113,"Vestibulum ac est lacinia nisi venenatis tristique. Fusce congue, diam id ornare imperdiet, sapien urna pretium nisl, ut volutpat sapien arcu sed augue. Aliquam erat volutpat.",30,510,59,5.1,8388,562,7826
600,"Tis kakomoiras",2012,"https://www.youtube.com/embed/kWuwuQ0X9OA","https://encrypted-tbn0.gstatic.com/images?q=tbn:ANd9GcQ1RC08Lpg31X2H7K5Uphlh7PGrzq7-JtVNzeSh-4UIh-JZbUaCDg",44,8.5,7256,573,6683,"Proin leo odio, porttitor id, consequat in, consequat ut, nulla. Sed accumsan felis. Ut at dolor quis odio consequat varius.",32,1277,38,8.3,2323,2606,-283
601,"Alive",2001,"https://www.youtube.com/embed/LO9I2fpyUyg","https://encrypted-tbn0.gstatic.com/images?q=tbn:ANd9GcT3yd_NJLFNa8pH2NX8GufmbmYJmY751UxjTNcB2ALIMGhKfx94gQ",26,1,7715,3648,4067,"Cras mi pede, malesuada in, imperdiet et, commodo vulputate, justo. In blandit ultrices enim. Lorem ipsum dolor sit amet, consectetuer adipiscing elit.",56,6139,9,8.1,1360,156,1204
602,"Wing and a Prayer",1992,"https://www.youtube.com/embed/h-k0-Z9b4Cw","https://encrypted-tbn0.gstatic.com/images?q=tbn:ANd9GcSBKrAU7qHXZ_vqij5HmW3xvTgSZ9qA7lT4fxAsUEXHGvWHHXai",68,1.2,7762,2443,5319,"Cum sociis natoque penatibus et magnis dis parturient montes, nascetur ridiculus mus. Vivamus vestibulum sagittis sapien. Cum sociis natoque penatibus et magnis dis parturient montes, nascetur ridiculus mus.",62,4252,95,7.8,8429,1983,6446
603,"The Law of the Weakest",1985,"https://www.youtube.com/embed/9g-j4wuEOPo","https://encrypted-tbn0.gstatic.com/images?q=tbn:ANd9GcRzG_G5zPWeZkXUBRL8pbpkKLG3hoQE92XKfYAayAo71EQzgXmv",70,4.8,9122,3771,5351,"Cum sociis natoque penatibus et magnis dis parturient montes, nascetur ridiculus mus. Vivamus vestibulum sagittis sapien. Cum sociis natoque penatibus et magnis dis parturient montes, nascetur ridiculus mus.",52,25,81,8.3,7393,1037,6356
604,"Gunday",2011,"https://www.youtube.com/embed/COTt1zvBUJk","https://encrypted-tbn0.gstatic.com/images?q=tbn:ANd9GcSH9tC-osjnxukCMxARZTOlLqboCFbGakXL0EtWmcFdJO1wQL38",84,8.4,1795,2311,-516,"Donec diam neque, vestibulum eget, vulputate ut, ultrices vel, augue. Vestibulum ante ipsum primis in faucibus orci luctus et ultrices posuere cubilia Curae; Donec pharetra, magna vestibulum aliquet ultrices, erat tortor sollicitudin mi, sit amet lobortis sapien sapien non mi. Integer ac neque.",54,7146,4,1,8611,1061,7550
605,"7 Women (a.k.a. Seven Women)",2011,"https://www.youtube.com/embed/QJlh0IPQbbo","https://encrypted-tbn0.gstatic.com/images?q=tbn:ANd9GcQ-Bo62SqPu_RKYOfA9eW-LQjqldSZ02v2_G5-UJtSlr8Qd948lLA",96,3.2,1555,213,1342,"Quisque porta volutpat erat. Quisque erat eros, viverra eget, congue eget, semper rutrum, nulla. Nunc purus.",74,6632,40,5.8,1795,8004,-6209
606,"The Living Magoroku",1999,"https://www.youtube.com/embed/cYAtvv-wopk","https://encrypted-tbn0.gstatic.com/images?q=tbn:ANd9GcSnUCe3jwoe6TiIdg0tv_j25Q3WHNDjeBfzqlYhOl70hy95_k9t1Q",89,5.1,5160,156,5004,"Nulla ut erat id mauris vulputate elementum. Nullam varius. Nulla facilisi.",30,8135,80,5.1,3530,8004,-4474
607,"The Long Voyage Home",2011,"https://www.youtube.com/embed/7C2Nad0aMPg","https://encrypted-tbn0.gstatic.com/images?q=tbn:ANd9GcR6OdK3cVIVUn07PmO7zFQb1JyTfdi6L4FwxFWOD9dfwTwN4hEt",87,6.8,8611,537,8074,"Proin eu mi. Nulla ac enim. In tempor, turpis nec euismod scelerisque, quam turpis adipiscing lorem, vitae mattis nibh ligula nec sem.",70,6777,57,3.6,698,4712,-4014
608,"Dr. Jekyll and Ms. Hyde",2001,"https://www.youtube.com/embed/tkSuLa3o_5A","https://encrypted-tbn0.gstatic.com/images?q=tbn:ANd9GcTppyYABMyqegOc4I6b3NS0iUaX0R6Cy1-PlahMrPPUzzqPNux9Gg",36,9.1,7383,1865,5518,"Proin interdum mauris non ligula pellentesque ultrices. Phasellus id sapien in sapien iaculis congue. Vivamus metus arcu, adipiscing molestie, hendrerit at, vulputate vitae, nisl.",84,5002,24,4.4,692,5209,-4517
609,"The Sword of Doom",1985,"https://www.youtube.com/embed/h-k0-Z9b4Cw","https://encrypted-tbn0.gstatic.com/images?q=tbn:ANd9GcS_NoH0Aw_5YFsBFwfBPn_O7YPHXumI5V3iQ2s7B-3zPU_7sSm1gA",64,1.1,7393,1865,5528,"Maecenas tristique, est et tempus semper, est quam pharetra magna, ac consequat metus sapien ut nunc. Vestibulum ante ipsum primis in faucibus orci luctus et ultrices posuere cubilia Curae; Mauris viverra diam vitae quam. Suspendisse potenti.",100,1836,69,1.2,9416,2965,6451
610,"The Wrong Move",1988,"https://www.youtube.com/embed/wKvOud9GcRQ","https://encrypted-tbn0.gstatic.com/images?q=tbn:ANd9GcQLt0-lz7NK5w-_elA1XCxyK77lQX2-JBVeEkkOx2aJ8RjYYqE4Vw",17,7.2,5542,4860,682,"Morbi non lectus. Aliquam sit amet diam in magna bibendum imperdiet. Nullam orci pede, venenatis non, sodales sed, tincidunt eu, felis.",26,2435,70,4.9,12,4196,-4184
611,"The Poseidon Adventure",2012,"https://www.youtube.com/embed/6Ui6m_eEEOI","https://encrypted-tbn0.gstatic.com/images?q=tbn:ANd9GcQ3liTMd9u-FOh16V1KslqpsRMQ7s9_8wAeiIkai8222SoHyIRe",41,3.4,3624,5284,-1660,"Donec diam neque, vestibulum eget, vulputate ut, ultrices vel, augue. Vestibulum ante ipsum primis in faucibus orci luctus et ultrices posuere cubilia Curae; Donec pharetra, magna vestibulum aliquet ultrices, erat tortor sollicitudin mi, sit amet lobortis sapien sapien non mi. Integer ac neque.",100,2822,57,9.7,5529,1741,3788
612,"Tis kakomoiras",2005,"https://www.youtube.com/embed/dfUJm6XgD7g","https://encrypted-tbn0.gstatic.com/images?q=tbn:ANd9GcSJJAS-aY5yM_o538SFwYJKMI1ICZvCAEdnVZX59tINRulVx7aBpA",61,1.1,7890,7219,671,"Duis aliquam convallis nunc. Proin at turpis a pede posuere nonummy. Integer non velit.",30,9164,30,1.8,8388,2443,5945
613,"Dr. Jekyll and Ms. Hyde",2005,"https://www.youtube.com/embed/cYAtvv-wopk","https://encrypted-tbn0.gstatic.com/images?q=tbn:ANd9GcSJJAS-aY5yM_o538SFwYJKMI1ICZvCAEdnVZX59tINRulVx7aBpA",28,6.1,3458,285,3173,"Integer ac leo. Pellentesque ultrices mattis odio. Donec vitae nisi.",96,6719,64,8.5,8715,781,7934
614,"Hardcore",2003,"https://www.youtube.com/embed/4AEkzL2SvmI","https://encrypted-tbn0.gstatic.com/images?q=tbn:ANd9GcQ6bssTSRlLtGI7nwGNoiKWx9hXXrZsIq1bCgawmuzsVpmbrHCZ3g",57,6.7,2987,73,2914,"Donec diam neque, vestibulum eget, vulputate ut, ultrices vel, augue. Vestibulum ante ipsum primis in faucibus orci luctus et ultrices posuere cubilia Curae; Donec pharetra, magna vestibulum aliquet ultrices, erat tortor sollicitudin mi, sit amet lobortis sapien sapien non mi. Integer ac neque.",26,3455,55,6.9,1360,2198,-838
615,"Poolboy: Drowning Out the Fury",2000,"https://www.youtube.com/embed/ee1172yeqyE","https://encrypted-tbn0.gstatic.com/images?q=tbn:ANd9GcQ1aky5NsvfU2oObNVwH5j9ZHJNNcxRkRhHEYTh8yhtqNLPmxk0lA",77,8.9,7890,6885,1005,"Sed ante. Vivamus tortor. Duis mattis egestas metus.",90,6113,84,9.1,2777,263,2514
616,"Thoroughly Modern Millie",1993,"https://www.youtube.com/embed/sZ8e_0i7UDk","https://encrypted-tbn0.gstatic.com/images?q=tbn:ANd9GcTsjOFvygMO8x-qvjqCJz2LIuSNcJ3SwoL3PgjTz-9CZFQxNyzGng",7,7.2,5160,2596,2564,"Proin interdum mauris non ligula pellentesque ultrices. Phasellus id sapien in sapien iaculis congue. Vivamus metus arcu, adipiscing molestie, hendrerit at, vulputate vitae, nisl.",40,3119,48,3.4,3411,573,2838
617,"Hype!",2011,"https://www.youtube.com/embed/iW3t_wUDG5U","https://encrypted-tbn0.gstatic.com/images?q=tbn:ANd9GcT3yd_NJLFNa8pH2NX8GufmbmYJmY751UxjTNcB2ALIMGhKfx94gQ",7,8.5,6734,3251,3483,"Morbi non lectus. Aliquam sit amet diam in magna bibendum imperdiet. Nullam orci pede, venenatis non, sodales sed, tincidunt eu, felis.",64,510,3,2.4,7715,3881,3834
618,"The Pit, the Pendulum and Hope",1992,"https://www.youtube.com/embed/ee1172yeqyE","https://encrypted-tbn0.gstatic.com/images?q=tbn:ANd9GcRUlnvuLTJg0mT65nGxwZY6OfVvev6DxlvShy5w5Mpai-i6Vk6Qfg",57,5.1,2987,7219,-4232,"Pellentesque at nulla. Suspendisse potenti. Cras in purus eu magna vulputate luctus.",28,4828,17,6.8,2733,1865,868
619,"Level Five",1996,"https://www.youtube.com/embed/1ywA8TtwJ50","https://encrypted-tbn0.gstatic.com/images?q=tbn:ANd9GcSfenuQRjGbddBAE4j3I_GN73Ch-EI9uairOfxWWbLQYAluLoDWCQ",70,4.6,3890,3412,478,"Integer tincidunt ante vel ipsum. Praesent blandit lacinia erat. Vestibulum sed magna at nunc commodo placerat.",68,7690,40,6.9,284,5515,-5231
620,"The King",2001,"https://www.youtube.com/embed/MpJEOpsVWtA","https://encrypted-tbn0.gstatic.com/images?q=tbn:ANd9GcSfdl_pNap7w4wYTP7dhiozrcmHAmCcADuvkKlsj19tBpxYkq60LA",31,4.6,6275,573,5702,"Cum sociis natoque penatibus et magnis dis parturient montes, nascetur ridiculus mus. Vivamus vestibulum sagittis sapien. Cum sociis natoque penatibus et magnis dis parturient montes, nascetur ridiculus mus.",24,5002,34,1.8,8816,7219,1597
621,"Dragon Ball Z the Movie: The World's Strongest (a.k.a. Dragon Ball Z: The Strongest Guy in The World) (Doragon bôru Z: Kono yo de ichiban tsuyoi yatsu)",1998,"https://www.youtube.com/embed/G9T_f7DjYho","https://encrypted-tbn0.gstatic.com/images?q=tbn:ANd9GcQYYT2HR82Tm6jDN6B_0-JbBC3HMcVQoxrwz0iiWHkiPx0sXczovQ",77,4.3,9994,772,9222,"Proin eu mi. Nulla ac enim. In tempor, turpis nec euismod scelerisque, quam turpis adipiscing lorem, vitae mattis nibh ligula nec sem.",50,1528,20,3.2,3890,537,3353
622,"Confidence",2010,"https://www.youtube.com/embed/_c3WIprIGHE","https://encrypted-tbn0.gstatic.com/images?q=tbn:ANd9GcSfdl_pNap7w4wYTP7dhiozrcmHAmCcADuvkKlsj19tBpxYkq60LA",13,9.6,3624,8964,-5340,"Praesent blandit. Nam nulla. Integer pede justo, lacinia eget, tincidunt eget, tempus vel, pede.",44,607,3,1.8,5954,1590,4364
623,"Overnight Delivery",1994,"https://www.youtube.com/embed/fPq4zW9QZSg","https://encrypted-tbn0.gstatic.com/images?q=tbn:ANd9GcSabPrm9QL3aakFmkc9kWlHSQ9uzP10Yf493F57vDv3FicybY8YIg",10,6.7,4324,7219,-2895,"Vestibulum ac est lacinia nisi venenatis tristique. Fusce congue, diam id ornare imperdiet, sapien urna pretium nisl, ut volutpat sapien arcu sed augue. Aliquam erat volutpat.",70,1317,83,6.9,8377,2443,5934
624,"The Land Before Time XII: The Great Day of the Flyers",1996,"https://www.youtube.com/embed/fnLjm_yL7vE","https://encrypted-tbn0.gstatic.com/images?q=tbn:ANd9GcRxLYJSuzc9AAuuJ3R1HulbKM_T8_whdwPZQj7VyYonHOME6fYq",81,4.1,7715,4196,3519,"Phasellus sit amet erat. Nulla tempus. Vivamus in felis eu sapien cursus vestibulum.",100,8567,6,2.1,3458,3118,340
625,"Sgt. Bilko",2007,"https://www.youtube.com/embed/Rc3e0m6SpXo","https://encrypted-tbn0.gstatic.com/images?q=tbn:ANd9GcRmeUcg7O8EkPtcOaGTwx1hvLuj5TbCPLmfq_zT0IhPpcbOWbBUDA",43,3.8,3605,1037,2568,"Quisque porta volutpat erat. Quisque erat eros, viverra eget, congue eget, semper rutrum, nulla. Nunc purus.",28,2866,75,2,7900,2965,4935
626,"The Prisoner",2012,"https://www.youtube.com/embed/RyYFAqJFYdE","https://encrypted-tbn0.gstatic.com/images?q=tbn:ANd9GcQ5LAO-oqK_jHF33R_asKWptHCRYc_456jcsgrngpU6q8htwl24",13,6.8,3019,156,2863,"Integer ac leo. Pellentesque ultrices mattis odio. Donec vitae nisi.",88,7702,18,3.4,8816,7462,1354
627,"Alive",2009,"https://www.youtube.com/embed/6SO96lvWqzc","https://encrypted-tbn0.gstatic.com/images?q=tbn:ANd9GcSYy4S-T_nbr708KkpYcV-RgmyX_MPtCXzFVr44X7S9CAQsyQAE3Q",19,4.1,8454,1983,6471,"Duis aliquam convallis nunc. Proin at turpis a pede posuere nonummy. Integer non velit.",72,9441,44,6.9,2847,2777,70
628,"Coming Down the Mountain",2007,"https://www.youtube.com/embed/fkr_djVWStU","https://encrypted-tbn0.gstatic.com/images?q=tbn:ANd9GcQzrbGfcJ8GKN78hn-r1fcQf4zH81e0MlsuOddkBJvhC5RvfF2DNw",89,6.1,2777,6366,-3589,"Aliquam quis turpis eget elit sodales scelerisque. Mauris sit amet eros. Suspendisse accumsan tortor quis turpis.",26,6632,22,8.3,7576,361,7215
629,"Sgt. Bilko",1998,"https://www.youtube.com/embed/fnLjm_yL7vE","https://encrypted-tbn0.gstatic.com/images?q=tbn:ANd9GcTpzv6ZkKQ_5fFlx242_ZFGnV3MuzyUBrlVMhbcTFBKJGCr7XxS",56,1.2,5541,1575,3966,"Sed sagittis. Nam congue, risus semper porta volutpat, quam pede lobortis ligula, sit amet eleifend pede libero quis orci. Nullam molestie nibh in lectus.",88,5258,57,3.1,6801,1741,5060
630,"Meet the Fockers",1989,"https://www.youtube.com/embed/6Ui6m_eEEOI","https://encrypted-tbn0.gstatic.com/images?q=tbn:ANd9GcTppyYABMyqegOc4I6b3NS0iUaX0R6Cy1-PlahMrPPUzzqPNux9Gg",69,6,7576,176,7400,"Praesent blandit. Nam nulla. Integer pede justo, lacinia eget, tincidunt eget, tempus vel, pede.",62,281,29,7.5,6199,2311,3888
631,"Lust for Gold",2006,"https://www.youtube.com/embed/2FbDY0MeJf8","https://encrypted-tbn0.gstatic.com/images?q=tbn:ANd9GcSQ-QvEfMwKoUuWLDF2x2M1V4BTEN6-uoYrr8ShYvdSVQcHru6h",31,6.7,3890,1575,2315,"Proin interdum mauris non ligula pellentesque ultrices. Phasellus id sapien in sapien iaculis congue. Vivamus metus arcu, adipiscing molestie, hendrerit at, vulputate vitae, nisl.",42,7069,57,7,6006,54,5952
632,"Dorado, El",2010,"https://www.youtube.com/embed/VccwBGgyzP4","https://encrypted-tbn0.gstatic.com/images?q=tbn:ANd9GcQLt0-lz7NK5w-_elA1XCxyK77lQX2-JBVeEkkOx2aJ8RjYYqE4Vw",18,1.2,3624,562,3062,"Curabitur at ipsum ac tellus semper interdum. Mauris ullamcorper purus sit amet nulla. Quisque arcu libero, rutrum ac, lobortis vel, dapibus at, diam.",28,2840,26,8.5,9496,1496,8000
633,"Operation 'Y' & Other Shurik's Adventures",2012,"https://www.youtube.com/embed/l-u3PdA-rpY","https://i.pinimg.com/236x/5f/f6/69/5ff6693c3694f55e8ed9738084c4c6b1--d-design-design-concepts.jpg",31,4.3,3411,573,2838,"In congue. Etiam justo. Etiam pretium iaculis justo.",56,510,96,1.8,8611,3118,5493
634,"Gorko!",2005,"https://www.youtube.com/embed/ocWpGdITSR4","https://encrypted-tbn0.gstatic.com/images?q=tbn:ANd9GcRWaaeSy6yTdILVOdHiDa9DWFAM4DhQ1JlJvUBR4vWbVoeZznD-",64,3.2,8446,1560,6886,"Donec diam neque, vestibulum eget, vulputate ut, ultrices vel, augue. Vestibulum ante ipsum primis in faucibus orci luctus et ultrices posuere cubilia Curae; Donec pharetra, magna vestibulum aliquet ultrices, erat tortor sollicitudin mi, sit amet lobortis sapien sapien non mi. Integer ac neque.",82,8851,41,4.9,8301,1037,7264
635,"The Tic Code",1992,"https://www.youtube.com/embed/fPq4zW9QZSg","https://encrypted-tbn0.gstatic.com/images?q=tbn:ANd9GcSZ6r6rDjMvQsp22jqT0ZPe_z-oKhAWQcjwgB5egzck4lqzLHYHCg",44,1.8,9683,5284,4399,"Sed ante. Vivamus tortor. Duis mattis egestas metus.",32,6159,44,4.2,8454,176,8278
636,"Man Is Not a Bird (Covek nije tica)",2010,"https://www.youtube.com/embed/YVYzxm_RqMg","https://encrypted-tbn0.gstatic.com/images?q=tbn:ANd9GcRboE_Oz4pmq_fbkSzc09GrZ6-FxQU9Zh64Y6b3LNLomLOlE4VEzQ",49,3.8,6755,4,6751,"Morbi non lectus. Aliquam sit amet diam in magna bibendum imperdiet. Nullam orci pede, venenatis non, sodales sed, tincidunt eu, felis.",28,1379,80,1.2,9496,6892,2604
637,"Man Is Not a Bird (Covek nije tica)",1991,"https://www.youtube.com/embed/ee12SvnnrSw","https://encrypted-tbn0.gstatic.com/images?q=tbn:ANd9GcTpzv6ZkKQ_5fFlx242_ZFGnV3MuzyUBrlVMhbcTFBKJGCr7XxS",18,5.1,9822,1741,8081,"Pellentesque at nulla. Suspendisse potenti. Cras in purus eu magna vulputate luctus.",70,1528,3,2.4,9141,1575,7566
638,"Little Boy Blue",2011,"https://www.youtube.com/embed/uaTAhjdaEuY","https://encrypted-tbn0.gstatic.com/images?q=tbn:ANd9GcQInYhbERWHKRlaq1eJAqZqaGQ9zndtpCyGofdPFToPGHuZUGCS",33,5.7,3530,2777,753,"Proin eu mi. Nulla ac enim. In tempor, turpis nec euismod scelerisque, quam turpis adipiscing lorem, vitae mattis nibh ligula nec sem.",30,9431,56,9.6,9090,1592,7498
639,"Isolation",1985,"https://www.youtube.com/embed/G9T_f7DjYho","https://encrypted-tbn0.gstatic.com/images?q=tbn:ANd9GcQvLz9_jwOs-MucEN-bWUhjq9aaYyfVvyNoFoGgGFdFJBMuXq1yqw",66,3.1,2409,1822,587,"Sed ante. Vivamus tortor. Duis mattis egestas metus.",50,7438,56,1.5,5704,5471,233
640,"The Innocent",2011,"https://www.youtube.com/embed/Rc3e0m6SpXo","https://encrypted-tbn0.gstatic.com/images?q=tbn:ANd9GcSmZDfgAQh9gNhDHM4YtECFcKd6iXDTMrn-PXI6Wylc9Lddn5ah-w",78,1.8,753,2308,-1555,"Sed sagittis. Nam congue, risus semper porta volutpat, quam pede lobortis ligula, sit amet eleifend pede libero quis orci. Nullam molestie nibh in lectus.",82,6868,66,7.7,3530,6366,-2836
641,"Miami Vice",2012,"https://www.youtube.com/embed/78ozCL4sQoI","https://encrypted-tbn0.gstatic.com/images?q=tbn:ANd9GcSfenuQRjGbddBAE4j3I_GN73Ch-EI9uairOfxWWbLQYAluLoDWCQ",89,2.1,8382,1496,6886,"Cum sociis natoque penatibus et magnis dis parturient montes, nascetur ridiculus mus. Vivamus vestibulum sagittis sapien. Cum sociis natoque penatibus et magnis dis parturient montes, nascetur ridiculus mus.",72,3444,88,9.7,698,1545,-847
642,"Miami Vice",2005,"https://www.youtube.com/embed/iOMxsy8S7hk","https://encrypted-tbn0.gstatic.com/images?q=tbn:ANd9GcSi9aOrS5oPJ7A3vLqJaEpNsmPCxVAYNwpoAl_G9K7p6pLBjaxALw",70,1.5,7383,4020,3363,"Morbi non lectus. Aliquam sit amet diam in magna bibendum imperdiet. Nullam orci pede, venenatis non, sodales sed, tincidunt eu, felis.",26,8851,65,8.8,3801,1741,2060
643,"Level Five",1991,"https://www.youtube.com/embed/8oTXc5t35Ro","https://encrypted-tbn0.gstatic.com/images?q=tbn:ANd9GcT11kibbY7ZQKvhvKatIRRKfv-n-n77Ve-QuVdMOoMg-fol_k9j",37,2.4,9389,2311,7078,"Praesent blandit. Nam nulla. Integer pede justo, lacinia eget, tincidunt eget, tempus vel, pede.",32,2840,38,7.5,3411,285,3126
644,"In the Line of Duty: The F.B.I. Murders",1998,"https://www.youtube.com/embed/yuYoFVHkvIA","https://encrypted-tbn0.gstatic.com/images?q=tbn:ANd9GcQhhglaTqXYejQ2b9TYl15F3E4pAgR1pWjyYyUTJgkHGuKsiWyHrw",88,1.7,1555,3428,-1873,"Proin leo odio, porttitor id, consequat in, consequat ut, nulla. Sed accumsan felis. Ut at dolor quis odio consequat varius.",40,5941,69,4.7,8816,4125,4691
645,"Alive",2007,"https://www.youtube.com/embed/uaTAhjdaEuY","https://encrypted-tbn0.gstatic.com/images?q=tbn:ANd9GcR203qZ3CqJHkReGO_urfLpOmRqqwbZ6g8ZOVV-2aZbySbWl_abdg",98,8.4,9122,1025,8097,"In congue. Etiam justo. Etiam pretium iaculis justo.",40,2667,77,2.4,5943,1590,4353
646,"Little Nikita",2007,"https://www.youtube.com/embed/2FbDY0MeJf8","https://encrypted-tbn0.gstatic.com/images?q=tbn:ANd9GcQT7MRD7KMXMfYFZ3Qi33LI-_bu1Q0DxOyhQgqolg06W2PrTbVuWg",84,2.4,6734,2999,3735,"Sed sagittis. Nam congue, risus semper porta volutpat, quam pede lobortis ligula, sit amet eleifend pede libero quis orci. Nullam molestie nibh in lectus.",28,6777,96,3.4,9683,5471,4212
647,"Of Love and Shadows",2007,"https://www.youtube.com/embed/fPq4zW9QZSg","https://encrypted-tbn0.gstatic.com/images?q=tbn:ANd9GcRUlnvuLTJg0mT65nGxwZY6OfVvev6DxlvShy5w5Mpai-i6Vk6Qfg",64,1.8,132,6892,-6760,"Morbi non lectus. Aliquam sit amet diam in magna bibendum imperdiet. Nullam orci pede, venenatis non, sodales sed, tincidunt eu, felis.",88,1589,42,3.2,6199,3881,2318
648,"Elvis Meets Nixon",2004,"https://www.youtube.com/embed/BQcvHEkGaEA","https://encrypted-tbn0.gstatic.com/images?q=tbn:ANd9GcQLt0-lz7NK5w-_elA1XCxyK77lQX2-JBVeEkkOx2aJ8RjYYqE4Vw",31,1.8,8429,3881,4548,"Phasellus in felis. Donec semper sapien a libero. Nam dui.",86,7069,48,9.3,5498,2489,3009
649,"The Innocent",1992,"https://www.youtube.com/embed/zCecE7OyVMU","https://encrypted-tbn0.gstatic.com/images?q=tbn:ANd9GcSnUCe3jwoe6TiIdg0tv_j25Q3WHNDjeBfzqlYhOl70hy95_k9t1Q",64,9.7,7715,1374,6341,"Pellentesque at nulla. Suspendisse potenti. Cras in purus eu magna vulputate luctus.",72,2822,68,9.5,9416,213,9203
650,"The Browning Version",2010,"https://www.youtube.com/embed/PdL8kn_G5EQ","https://encrypted-tbn0.gstatic.com/images?q=tbn:ANd9GcQ6bssTSRlLtGI7nwGNoiKWx9hXXrZsIq1bCgawmuzsVpmbrHCZ3g",55,1.8,6006,1374,4632,"Morbi non lectus. Aliquam sit amet diam in magna bibendum imperdiet. Nullam orci pede, venenatis non, sodales sed, tincidunt eu, felis.",38,9164,42,1.8,7715,3527,4188
651,"7 Women (a.k.a. Seven Women)",2008,"https://www.youtube.com/embed/-6jCNhebfg8","https://encrypted-tbn0.gstatic.com/images?q=tbn:ANd9GcRqaaKELSsRKJh2pc05f1s5ksCTCIa-bgxbzGUm2T7leAI2nlTqZw",35,7.5,2409,2443,-34,"Aenean lectus. Pellentesque eget nunc. Donec quis orci eget orci vehicula condimentum.",58,9382,26,1.8,2733,3771,-1038
652,"Quand je serai petit",2010,"https://www.youtube.com/embed/78ozCL4sQoI","https://encrypted-tbn0.gstatic.com/images?q=tbn:ANd9GcSQ-QvEfMwKoUuWLDF2x2M1V4BTEN6-uoYrr8ShYvdSVQcHru6h",89,3.2,5146,1496,3650,"Maecenas tristique, est et tempus semper, est quam pharetra magna, ac consequat metus sapien ut nunc. Vestibulum ante ipsum primis in faucibus orci luctus et ultrices posuere cubilia Curae; Mauris viverra diam vitae quam. Suspendisse potenti.",30,3441,22,1.7,3890,6427,-2537
653,"In the Line of Duty: The F.B.I. Murders",1985,"https://www.youtube.com/embed/8W6yYBAUxv4","https://encrypted-tbn0.gstatic.com/images?q=tbn:ANd9GcSr9sVCqvsx-91eeqQvyCjpe4Fo7sap42UGJTn3IzdyIQVFy39R",98,9.5,6199,573,5626,"Sed sagittis. Nam congue, risus semper porta volutpat, quam pede lobortis ligula, sit amet eleifend pede libero quis orci. Nullam molestie nibh in lectus.",40,8647,87,2,5943,627,5316
654,"Lust for Gold",1968,"https://www.youtube.com/embed/3svtRyLq3b0","https://encrypted-tbn0.gstatic.com/images?q=tbn:ANd9GcSJJAS-aY5yM_o538SFwYJKMI1ICZvCAEdnVZX59tINRulVx7aBpA",34,4.6,8611,5209,3402,"Maecenas ut massa quis augue luctus tincidunt. Nulla mollis molestie lorem. Quisque ut erat.",62,93,56,1.8,3411,5206,-1795
655,"Dorado, El",2005,"https://www.youtube.com/embed/SF0w2B6DNUE","https://encrypted-tbn0.gstatic.com/images?q=tbn:ANd9GcTTLFfQrJmhvXjL4d_udm6Z89QYglVi4hTEmbaDRdDoqHQsaQVg",17,1.5,6662,2999,3663,"Proin eu mi. Nulla ac enim. In tempor, turpis nec euismod scelerisque, quam turpis adipiscing lorem, vitae mattis nibh ligula nec sem.",82,9382,77,4.2,2847,5471,-2624
656,"Wing and a Prayer",2009,"https://www.youtube.com/embed/MPWMBITCudM","https://encrypted-tbn0.gstatic.com/images?q=tbn:ANd9GcQvfJ-vLQ5TK13ND8sY6H-r6cm_4f3SnW_WAWn2vuX-nGh6F8JquQ",6,1,6869,3607,3262,"Aliquam quis turpis eget elit sodales scelerisque. Mauris sit amet eros. Suspendisse accumsan tortor quis turpis.",100,1442,34,1.1,5541,3118,2423
657,"American Pie Presents The Naked Mile (American Pie 5: The Naked Mile)",2001,"https://www.youtube.com/embed/zCecE7OyVMU","https://encrypted-tbn0.gstatic.com/images?q=tbn:ANd9GcSH9tC-osjnxukCMxARZTOlLqboCFbGakXL0EtWmcFdJO1wQL38",96,2,6662,1865,4797,"Cum sociis natoque penatibus et magnis dis parturient montes, nascetur ridiculus mus. Vivamus vestibulum sagittis sapien. Cum sociis natoque penatibus et magnis dis parturient montes, nascetur ridiculus mus.",38,7069,36,6.9,6275,3563,2712
658,"7 Women (a.k.a. Seven Women)",2001,"https://www.youtube.com/embed/keo8PJecIEc","https://encrypted-tbn0.gstatic.com/images?q=tbn:ANd9GcSmZDfgAQh9gNhDHM4YtECFcKd6iXDTMrn-PXI6Wylc9Lddn5ah-w",3,5.9,4286,5228,-942,"Maecenas tristique, est et tempus semper, est quam pharetra magna, ac consequat metus sapien ut nunc. Vestibulum ante ipsum primis in faucibus orci luctus et ultrices posuere cubilia Curae; Mauris viverra diam vitae quam. Suspendisse potenti.",48,6777,50,9.3,4286,4196,90
659,"Bullet",1985,"https://www.youtube.com/embed/VUEaDUyeTR8","https://encrypted-tbn0.gstatic.com/images?q=tbn:ANd9GcRUMZIkgEW4ZtYyXTgo6uGdYksy7dreOkd-zJRc1uGna-GAnU3SDQ",98,6.3,9090,7659,1431,"Vestibulum quam sapien, varius ut, blandit non, interdum in, ante. Vestibulum ante ipsum primis in faucibus orci luctus et ultrices posuere cubilia Curae; Duis faucibus accumsan odio. Curabitur convallis.",86,7612,26,1,9141,8629,512
660,"Transylvania",1984,"https://www.youtube.com/embed/RaA9elSYnpQ","https://encrypted-tbn0.gstatic.com/images?q=tbn:ANd9GcSkP7ePajJciblvooQK7qTSV2J0ZdjBzPxrRi7NvBHdmOLYWeT4",83,1.1,8611,176,8435,"Curabitur in libero ut massa volutpat convallis. Morbi odio odio, elementum eu, interdum eu, tincidunt in, leo. Maecenas pulvinar lobortis est.",28,9382,23,6.9,1555,2777,-1222
661,"Rabid Grannies (Mémés cannibales, Les)",1985,"https://www.youtube.com/embed/fnLjm_yL7vE","https://encrypted-tbn0.gstatic.com/images?q=tbn:ANd9GcTVx6QbLHPUKkVSj1TkaOANhnRfjtIXHhKnHSaIR2y3RkCgry-X",6,8.5,3019,537,2482,"Morbi non lectus. Aliquam sit amet diam in magna bibendum imperdiet. Nullam orci pede, venenatis non, sodales sed, tincidunt eu, felis.",80,5537,4,3.1,8816,5284,3532
662,"Rabid Grannies (Mémés cannibales, Les)",1968,"https://www.youtube.com/embed/wKvOud9GcRQ","https://encrypted-tbn0.gstatic.com/images?q=tbn:ANd9GcTt-58zOD-K4oKQ0AbvYduMdi-NxFRYLjx9Maf9ECQJMZkvfanqUw",80,7,2777,1575,1202,"Curabitur in libero ut massa volutpat convallis. Morbi odio odio, elementum eu, interdum eu, tincidunt in, leo. Maecenas pulvinar lobortis est.",26,223,90,6.9,9122,5228,3894
663,"Coming Down the Mountain",2012,"https://www.youtube.com/embed/mAX1oGLvMAA","https://encrypted-tbn0.gstatic.com/images?q=tbn:ANd9GcQKE0-ggtSuRrbc-0BlaVgTBu4zGwn22cMB8tEdwr9uHJJ9jXGs",62,7.7,4108,8629,-4521,"Curabitur in libero ut massa volutpat convallis. Morbi odio odio, elementum eu, interdum eu, tincidunt in, leo. Maecenas pulvinar lobortis est.",100,9178,78,2.4,1555,6366,-4811
664,"Babylon 5: In the Beginning",2006,"https://www.youtube.com/embed/YVYzxm_RqMg","https://encrypted-tbn0.gstatic.com/images?q=tbn:ANd9GcQYYT2HR82Tm6jDN6B_0-JbBC3HMcVQoxrwz0iiWHkiPx0sXczovQ",31,9.3,2779,3074,-295,"Morbi porttitor lorem id ligula. Suspendisse ornare consequat lectus. In est risus, auctor sed, tristique in, tempus sit amet, sem.",62,1379,34,6.3,8382,1545,6837
665,"Harry Potter and the Order of the Phoenix",1998,"https://www.youtube.com/embed/I7YdOosOjTU","https://encrypted-tbn0.gstatic.com/images?q=tbn:ANd9GcTjDxlkO4SurlCq11A009Vm2yOW0XT4x5GHflg-pkVrTiqWURnydg",3,2.9,8816,4,8812,"Fusce consequat. Nulla nisl. Nunc nisl.",64,9857,62,2.4,7715,156,7559
666,"Rabid Grannies (Mémés cannibales, Les)",1965,"https://www.youtube.com/embed/2FbDY0MeJf8","https://encrypted-tbn0.gstatic.com/images?q=tbn:ANd9GcQ--11hFR6GYIOagDhcOJiqKSIqKz7XB_wRhQklbSwf9d4k8lto",64,3.4,692,3527,-2835,"Proin eu mi. Nulla ac enim. In tempor, turpis nec euismod scelerisque, quam turpis adipiscing lorem, vitae mattis nibh ligula nec sem.",44,5410,77,1.8,8611,215,8396
667,"Little Giants",2012,"https://www.youtube.com/embed/2FbDY0MeJf8","https://encrypted-tbn0.gstatic.com/images?q=tbn:ANd9GcSH9tC-osjnxukCMxARZTOlLqboCFbGakXL0EtWmcFdJO1wQL38",66,2.1,8429,5206,3223,"Quisque porta volutpat erat. Quisque erat eros, viverra eget, congue eget, semper rutrum, nulla. Nunc purus.",88,6868,29,4.7,3624,1545,2079
668,"The Iran Job",1994,"https://www.youtube.com/embed/8W6yYBAUxv4","https://encrypted-tbn0.gstatic.com/images?q=tbn:ANd9GcTVx6QbLHPUKkVSj1TkaOANhnRfjtIXHhKnHSaIR2y3RkCgry-X",3,4.1,6386,3648,2738,"Praesent blandit. Nam nulla. Integer pede justo, lacinia eget, tincidunt eget, tempus vel, pede.",64,1589,9,4.6,6662,2308,4354
669,"Dorado, El",2006,"https://www.youtube.com/embed/2FbDY0MeJf8","https://encrypted-tbn0.gstatic.com/images?q=tbn:ANd9GcSxYkdQhkFdrUcKH8fJB2yXGC_mRCGuYTVOQUJTDJY0t9GQ7I2_",75,1.7,7383,3118,4265,"In sagittis dui vel nisl. Duis ac nibh. Fusce lacus purus, aliquet at, feugiat non, pretium quis, lectus.",26,8065,18,7.5,2733,2489,244
670,"Block-Heads",1994,"https://www.youtube.com/embed/MNp1LPm3Krs","https://encrypted-tbn0.gstatic.com/images?q=tbn:ANd9GcRTcG2_JqWMZJOf6uyZm7vI1GQGSsjWkKgxCokuA40pthaOj9LOFQ",70,8.3,6869,225,6644,"Integer tincidunt ante vel ipsum. Praesent blandit lacinia erat. Vestibulum sed magna at nunc commodo placerat.",62,1277,56,1.8,9090,2443,6647
671,"The Stars Fell on Henrietta",1999,"https://www.youtube.com/embed/Xwzwmc2AZYg","https://encrypted-tbn0.gstatic.com/images?q=tbn:ANd9GcSutU5UF40fwtxDcA61fL6VFTPKJYlaJOeUxSuI4qfpFQYO1KZ3",13,8.4,8429,3074,5355,"Proin eu mi. Nulla ac enim. In tempor, turpis nec euismod scelerisque, quam turpis adipiscing lorem, vitae mattis nibh ligula nec sem.",66,223,40,8.4,7256,213,7043
672,"The Possession of Michael King",1995,"https://www.youtube.com/embed/hgBj5b1TTDQ","https://encrypted-tbn0.gstatic.com/images?q=tbn:ANd9GcQ1RC08Lpg31X2H7K5Uphlh7PGrzq7-JtVNzeSh-4UIh-JZbUaCDg",11,7.7,2777,7462,-4685,"Proin leo odio, porttitor id, consequat in, consequat ut, nulla. Sed accumsan felis. Ut at dolor quis odio consequat varius.",26,510,20,3.1,7256,2308,4948
673,"The Law of the Weakest",1992,"https://www.youtube.com/embed/iOMxsy8S7hk","https://encrypted-tbn0.gstatic.com/images?q=tbn:ANd9GcQ1RC08Lpg31X2H7K5Uphlh7PGrzq7-JtVNzeSh-4UIh-JZbUaCDg",11,6.3,2779,5471,-2692,"Curabitur in libero ut massa volutpat convallis. Morbi odio odio, elementum eu, interdum eu, tincidunt in, leo. Maecenas pulvinar lobortis est.",88,8039,30,8.9,9090,361,8729
674,"U2: Rattle and Hum",1992,"https://www.youtube.com/embed/ee1172yeqyE","https://encrypted-tbn0.gstatic.com/images?q=tbn:ANd9GcQj3o8UxHr9-tOcX5N5ppAE1Y9EZS5-9IYjKEogAzmsetJB5g0w",19,2.4,8454,562,7892,"Fusce consequat. Nulla nisl. Nunc nisl.",50,2435,69,1.1,1191,2001,-810
675,"Of Love and Shadows",1996,"https://www.youtube.com/embed/7C2Nad0aMPg","https://encrypted-tbn0.gstatic.com/images?q=tbn:ANd9GcSsoy4iP--KOCJ5pPhAcbfrQSvWLPYPI3I557hNf2Vfb6OrfrOczg",64,7.2,3458,1037,2421,"Suspendisse potenti. In eleifend quam a odio. In hac habitasse platea dictumst.",38,1649,66,9.7,2016,2443,-427
676,"Sky Fighters (Les Chevaliers Du Ciel)",2011,"https://www.youtube.com/embed/MExr5cmGsC4","https://encrypted-tbn0.gstatic.com/images?q=tbn:ANd9GcTt-58zOD-K4oKQ0AbvYduMdi-NxFRYLjx9Maf9ECQJMZkvfanqUw",3,7,6801,2352,4449,"Nam ultrices, libero non mattis pulvinar, nulla pede ullamcorper augue, a suscipit nulla elit ac nulla. Sed vel enim sit amet nunc viverra dapibus. Nulla suscipit ligula in lacus.",88,8546,41,1.5,6469,7219,-750
677,"Lust for Gold",1965,"https://www.youtube.com/embed/YWbrTLsplyA","https://encrypted-tbn0.gstatic.com/images?q=tbn:ANd9GcTZlJW6ILTHoyypnMTvpWTFl3IhTXHYM5kQntofSVvdKEozMRsTxQ",17,4.3,8715,176,8539,"Proin leo odio, porttitor id, consequat in, consequat ut, nulla. Sed accumsan felis. Ut at dolor quis odio consequat varius.",66,6159,22,3.6,198,1214,-1016
678,"Breaking the Silence: Truth and Lies in the War on Terror",2004,"https://www.youtube.com/embed/MpJEOpsVWtA","https://encrypted-tbn0.gstatic.com/images?q=tbn:ANd9GcQ1aky5NsvfU2oObNVwH5j9ZHJNNcxRkRhHEYTh8yhtqNLPmxk0lA",70,3.2,9141,6554,2587,"Curabitur at ipsum ac tellus semper interdum. Mauris ullamcorper purus sit amet nulla. Quisque arcu libero, rutrum ac, lobortis vel, dapibus at, diam.",66,9885,81,5.4,8410,156,8254
679,"The Cell 2",2007,"https://www.youtube.com/embed/2FbDY0MeJf8","https://encrypted-tbn0.gstatic.com/images?q=tbn:ANd9GcSaZZLwGXqiNU5rkhexU86wKZGzymZWTp2nKRDFdITh7rD7Jb6yGA",2,2.8,692,7462,-6770,"Cum sociis natoque penatibus et magnis dis parturient montes, nascetur ridiculus mus. Vivamus vestibulum sagittis sapien. Cum sociis natoque penatibus et magnis dis parturient montes, nascetur ridiculus mus.",30,6673,78,2.4,7900,5515,2385
680,"Confidence",2002,"https://www.youtube.com/embed/YoBOCxBq88A","https://encrypted-tbn0.gstatic.com/images?q=tbn:ANd9GcRxLYJSuzc9AAuuJ3R1HulbKM_T8_whdwPZQj7VyYonHOME6fYq",26,3.1,8226,1061,7165,"Praesent blandit. Nam nulla. Integer pede justo, lacinia eget, tincidunt eget, tempus vel, pede.",52,458,70,8.1,8226,562,7664
681,"Confidence",2004,"https://www.youtube.com/embed/qqlEGYo0xCA","https://encrypted-tbn0.gstatic.com/images?q=tbn:ANd9GcQT7MRD7KMXMfYFZ3Qi33LI-_bu1Q0DxOyhQgqolg06W2PrTbVuWg",49,8.4,3624,1822,1802,"Cum sociis natoque penatibus et magnis dis parturient montes, nascetur ridiculus mus. Vivamus vestibulum sagittis sapien. Cum sociis natoque penatibus et magnis dis parturient montes, nascetur ridiculus mus.",60,8363,70,6.8,8410,2443,5967
682,"Talcum Powder",1985,"https://www.youtube.com/embed/LcepHRTWI18","https://encrypted-tbn0.gstatic.com/images?q=tbn:ANd9GcRTcG2_JqWMZJOf6uyZm7vI1GQGSsjWkKgxCokuA40pthaOj9LOFQ",6,3.4,2847,4125,-1278,"Pellentesque at nulla. Suspendisse potenti. Cras in purus eu magna vulputate luctus.",88,6777,26,1.1,5696,361,5335
683,"The Living Magoroku",2009,"https://www.youtube.com/embed/KbZ3TVEkuDY","https://encrypted-tbn0.gstatic.com/images?q=tbn:ANd9GcS5gl0DLTFbt7bYHEmtfUaWEKVmT1jfD8Td6ILXO_YOKSFekX9e",2,5.1,7683,537,7146,"Quisque porta volutpat erat. Quisque erat eros, viverra eget, congue eget, semper rutrum, nulla. Nunc purus.",100,7069,20,6.9,5696,1733,3963
684,"Dragon Ball Z the Movie: The World's Strongest (a.k.a. Dragon Ball Z: The Strongest Guy in The World) (Doragon bôru Z: Kono yo de ichiban tsuyoi yatsu)",2012,"https://www.youtube.com/embed/YVYzxm_RqMg","https://encrypted-tbn0.gstatic.com/images?q=tbn:ANd9GcQ06LkOABmCBkCQO4wr6V0tHNUOyUYNR-YLaEHAblZo1ZqlooBmOg",25,8.1,3605,2965,640,"Quisque porta volutpat erat. Quisque erat eros, viverra eget, congue eget, semper rutrum, nulla. Nunc purus.",88,6159,55,7,3624,5206,-1582
685,"The Paradine Case",1999,"https://www.youtube.com/embed/DIOW-kR_ams","https://encrypted-tbn0.gstatic.com/images?q=tbn:ANd9GcQYYT2HR82Tm6jDN6B_0-JbBC3HMcVQoxrwz0iiWHkiPx0sXczovQ",49,9,9389,1214,8175,"Proin eu mi. Nulla ac enim. In tempor, turpis nec euismod scelerisque, quam turpis adipiscing lorem, vitae mattis nibh ligula nec sem.",52,1379,80,6.9,5943,4712,1231
686,"The Stars Fell on Henrietta",1987,"https://www.youtube.com/embed/hgBj5b1TTDQ","https://encrypted-tbn0.gstatic.com/images?q=tbn:ANd9GcRUMZIkgEW4ZtYyXTgo6uGdYksy7dreOkd-zJRc1uGna-GAnU3SDQ",38,1.4,7162,218,6944,"Vestibulum ac est lacinia nisi venenatis tristique. Fusce congue, diam id ornare imperdiet, sapien urna pretium nisl, ut volutpat sapien arcu sed augue. Aliquam erat volutpat.",54,6632,78,8.8,3923,3648,275
687,"The Big Trail",2003,"https://www.youtube.com/embed/_aHDqS8EMn0","https://encrypted-tbn0.gstatic.com/images?q=tbn:ANd9GcTohJTJK1v5tSnhy3g7gvaali5Xq0Qq6MwRJMGVD5enka23vy2H",40,6,3458,2308,1150,"Donec diam neque, vestibulum eget, vulputate ut, ultrices vel, augue. Vestibulum ante ipsum primis in faucibus orci luctus et ultrices posuere cubilia Curae; Donec pharetra, magna vestibulum aliquet ultrices, erat tortor sollicitudin mi, sit amet lobortis sapien sapien non mi. Integer ac neque.",54,2476,3,6.7,4286,3527,759
688,"Protector (Protektor)",1985,"https://www.youtube.com/embed/Xwzwmc2AZYg","https://i.pinimg.com/236x/5f/f6/69/5ff6693c3694f55e8ed9738084c4c6b1--d-design-design-concepts.jpg",66,3.2,5146,4124,1022,"Praesent blandit. Nam nulla. Integer pede justo, lacinia eget, tincidunt eget, tempus vel, pede.",88,4091,43,2.1,8382,3313,5069
689,"Wing and a Prayer",1999,"https://www.youtube.com/embed/SF0w2B6DNUE","https://encrypted-tbn0.gstatic.com/images?q=tbn:ANd9GcT4OdTRV0WhSYFs5jcy1IZYf9s7DjJToLKAVXlTv4GhzQcgmD-C",33,1.5,5541,3771,1770,"Morbi porttitor lorem id ligula. Suspendisse ornare consequat lectus. In est risus, auctor sed, tristique in, tempus sit amet, sem.",52,1379,64,8.3,4602,3563,1039
690,"Holy Flame of the Martial World (Wu lin sheng huo jin)",2005,"https://www.youtube.com/embed/hgBj5b1TTDQ","https://encrypted-tbn0.gstatic.com/images?q=tbn:ANd9GcSfdl_pNap7w4wYTP7dhiozrcmHAmCcADuvkKlsj19tBpxYkq60LA",70,8.4,8388,2352,6036,"Nulla ut erat id mauris vulputate elementum. Nullam varius. Nulla facilisi.",26,3074,23,9.3,2777,2240,537
691,"Dragon Ball Z the Movie: The World's Strongest (a.k.a. Dragon Ball Z: The Strongest Guy in The World) (Doragon bôru Z: Kono yo de ichiban tsuyoi yatsu)",2007,"https://www.youtube.com/embed/SF0w2B6DNUE","https://encrypted-tbn0.gstatic.com/images?q=tbn:ANd9GcRWaaeSy6yTdILVOdHiDa9DWFAM4DhQ1JlJvUBR4vWbVoeZznD-",22,1.4,2323,3563,-1240,"Praesent blandit. Nam nulla. Integer pede justo, lacinia eget, tincidunt eget, tempus vel, pede.",96,2682,80,3.9,7383,2711,4672
692,"The King",2002,"https://www.youtube.com/embed/MPWMBITCudM","https://encrypted-tbn0.gstatic.com/images?q=tbn:ANd9GcQ4tG7BC0SE2SNUji4NBAmTKKl13L-IuMZpkiEbQm0YeWk9Z1SQUg",77,3.2,5541,8004,-2463,"Integer tincidunt ante vel ipsum. Praesent blandit lacinia erat. Vestibulum sed magna at nunc commodo placerat.",30,7069,60,6.8,8816,1733,7083
693,"The Poseidon Adventure",1994,"https://www.youtube.com/embed/VUEaDUyeTR8","https://encrypted-tbn0.gstatic.com/images?q=tbn:ANd9GcTlHaTq59e08Zugqn9ZX71XQYUOtuUGEQ9Mkl_HR1NmuSBceL7O",26,1.2,12,4020,-4008,"Vestibulum ac est lacinia nisi venenatis tristique. Fusce congue, diam id ornare imperdiet, sapien urna pretium nisl, ut volutpat sapien arcu sed augue. Aliquam erat volutpat.",58,2789,59,2.4,3890,285,3605
694,"The Paradine Case",2003,"https://www.youtube.com/embed/cYAtvv-wopk","https://encrypted-tbn0.gstatic.com/images?q=tbn:ANd9GcQtbFBdNfjGVCo1GPJC_9PUkUc7wRIwwh0PMwS76SEP_QTtAyat",2,2.4,4324,2606,1718,"Proin leo odio, porttitor id, consequat in, consequat ut, nulla. Sed accumsan felis. Ut at dolor quis odio consequat varius.",32,9441,81,8.8,7162,2596,4566
695,"American Pie Presents The Naked Mile (American Pie 5: The Naked Mile)",2001,"https://www.youtube.com/embed/LcepHRTWI18","https://encrypted-tbn0.gstatic.com/images?q=tbn:ANd9GcR_EXv1N1pkhMX0O3KAJXlTgC0_KL4WpSRDxUzH2CO9RPypuvxDAw",9,5.1,9994,6366,3628,"Sed ante. Vivamus tortor. Duis mattis egestas metus.",88,4907,41,5.1,2733,573,2160
696,"The Big Trail",2010,"https://www.youtube.com/embed/G9T_f7DjYho","https://encrypted-tbn0.gstatic.com/images?q=tbn:ANd9GcQYYT2HR82Tm6jDN6B_0-JbBC3HMcVQoxrwz0iiWHkiPx0sXczovQ",2,3.4,9899,2311,7588,"Fusce consequat. Nulla nisl. Nunc nisl.",100,7690,22,7,3890,2001,1889
697,"Hype!",2011,"https://www.youtube.com/embed/MaI-4NepPfU","https://encrypted-tbn0.gstatic.com/images?q=tbn:ANd9GcSabPrm9QL3aakFmkc9kWlHSQ9uzP10Yf493F57vDv3FicybY8YIg",26,2.1,2016,1061,955,"Lorem ipsum dolor sit amet, consectetuer adipiscing elit. Proin risus. Praesent lectus.",100,3119,6,3.8,3530,5,3525
698,"Talcum Powder",1994,"https://www.youtube.com/embed/keo8PJecIEc","https://encrypted-tbn0.gstatic.com/images?q=tbn:ANd9GcQoGIgMrMpVA2TiWG8g9ENb7x-ZrciYB-gqzjyCnG-C2EgT8ePfkA",55,2,9416,6554,2862,"In congue. Etiam justo. Etiam pretium iaculis justo.",40,1528,31,8.3,7576,5206,2370
699,"Overnight Delivery",1965,"https://www.youtube.com/embed/7C2Nad0aMPg","https://encrypted-tbn0.gstatic.com/images?q=tbn:ANd9GcQ1aky5NsvfU2oObNVwH5j9ZHJNNcxRkRhHEYTh8yhtqNLPmxk0lA",81,9.7,8715,3648,5067,"Phasellus sit amet erat. Nulla tempus. Vivamus in felis eu sapien cursus vestibulum.",52,8135,22,4.3,3411,5515,-2104
700,"Bullet",2008,"https://www.youtube.com/embed/_aHDqS8EMn0","https://encrypted-tbn0.gstatic.com/images?q=tbn:ANd9GcS0uoN_00qCw12_q1GgGAdcbA-6sp6JzFguYZMxLObI8Ydh9OBk",22,1.8,5696,627,5069,"Maecenas leo odio, condimentum id, luctus nec, molestie sed, justo. Pellentesque viverra pede ac diam. Cras pellentesque volutpat dui.",40,7690,45,8.3,6579,6427,152
701,"Thunder Bay",2006,"https://www.youtube.com/embed/RaA9elSYnpQ","https://encrypted-tbn0.gstatic.com/images?q=tbn:ANd9GcSC_qEbYtBeELogQVPTeiWNRbcOXlYKbMYmMPaG67T_yrWKEiTV",55,1.2,7890,1822,6068,"Sed sagittis. Nam congue, risus semper porta volutpat, quam pede lobortis ligula, sit amet eleifend pede libero quis orci. Nullam molestie nibh in lectus.",84,8234,4,4.6,1360,3881,-2521
702,"The Last Seduction",2010,"https://www.youtube.com/embed/OWwVD1xdAX4","https://encrypted-tbn0.gstatic.com/images?q=tbn:ANd9GcS0uoN_00qCw12_q1GgGAdcbA-6sp6JzFguYZMxLObI8Ydh9OBk",29,7.7,2733,7462,-4729,"Maecenas ut massa quis augue luctus tincidunt. Nulla mollis molestie lorem. Quisque ut erat.",30,6673,29,4.8,7576,772,6804
703,"When Time Ran Out...",1989,"https://www.youtube.com/embed/G9T_f7DjYho","https://encrypted-tbn0.gstatic.com/images?q=tbn:ANd9GcQ1aky5NsvfU2oObNVwH5j9ZHJNNcxRkRhHEYTh8yhtqNLPmxk0lA",78,5.7,6386,225,6161,"Quisque porta volutpat erat. Quisque erat eros, viverra eget, congue eget, semper rutrum, nulla. Nunc purus.",48,9441,10,6.8,3530,285,3245
704,"The Stars Fell on Henrietta",2012,"https://www.youtube.com/embed/1ywA8TtwJ50","https://encrypted-tbn0.gstatic.com/images?q=tbn:ANd9GcTlHaTq59e08Zugqn9ZX71XQYUOtuUGEQ9Mkl_HR1NmuSBceL7O",40,2,9899,2596,7303,"Maecenas leo odio, condimentum id, luctus nec, molestie sed, justo. Pellentesque viverra pede ac diam. Cras pellentesque volutpat dui.",64,3441,87,3.2,8816,2489,6327
705,"Dorado, El",2006,"https://www.youtube.com/embed/vuzplFd3YVY","https://encrypted-tbn0.gstatic.com/images?q=tbn:ANd9GcRyMl7AW_r-FXiuqUSSUA5Mww484NZ8QAd_-vEbcfX2bB8j-uCn1g",20,1.2,8388,4712,3676,"Aliquam quis turpis eget elit sodales scelerisque. Mauris sit amet eros. Suspendisse accumsan tortor quis turpis.",28,5258,38,6.7,1555,2489,-934
706,"Murder Ahoy",2001,"https://www.youtube.com/embed/THq6KlWgiqw","https://encrypted-tbn0.gstatic.com/images?q=tbn:ANd9GcSi9aOrS5oPJ7A3vLqJaEpNsmPCxVAYNwpoAl_G9K7p6pLBjaxALw",19,5.4,4286,1061,3225,"Aliquam quis turpis eget elit sodales scelerisque. Mauris sit amet eros. Suspendisse accumsan tortor quis turpis.",26,6719,28,6,2987,2308,679
707,"Dr. Jekyll and Ms. Hyde",1997,"https://www.youtube.com/embed/DIOW-kR_ams","https://encrypted-tbn0.gstatic.com/images?q=tbn:ANd9GcRUMZIkgEW4ZtYyXTgo6uGdYksy7dreOkd-zJRc1uGna-GAnU3SDQ",55,7.8,6006,2606,3400,"Proin eu mi. Nulla ac enim. In tempor, turpis nec euismod scelerisque, quam turpis adipiscing lorem, vitae mattis nibh ligula nec sem.",58,1620,45,5.8,7890,73,7817
708,"People Will Talk",2001,"https://www.youtube.com/embed/MaI-4NepPfU","https://encrypted-tbn0.gstatic.com/images?q=tbn:ANd9GcTiS27rf1ltLwxOAbTBhYvqJuvJG8ctIALtoknQh7MHlvV3r0UO",55,3.4,7890,361,7529,"Donec diam neque, vestibulum eget, vulputate ut, ultrices vel, augue. Vestibulum ante ipsum primis in faucibus orci luctus et ultrices posuere cubilia Curae; Donec pharetra, magna vestibulum aliquet ultrices, erat tortor sollicitudin mi, sit amet lobortis sapien sapien non mi. Integer ac neque.",98,6770,66,7.8,698,156,542
709,"Overnight Delivery",1996,"https://www.youtube.com/embed/LO9I2fpyUyg","https://encrypted-tbn0.gstatic.com/images?q=tbn:ANd9GcQKE0-ggtSuRrbc-0BlaVgTBu4zGwn22cMB8tEdwr9uHJJ9jXGs",82,4.1,6801,1822,4979,"Duis bibendum. Morbi non quam nec dui luctus rutrum. Nulla tellus.",96,2153,61,5.1,8446,5284,3162
710,"Transylvania",2008,"https://www.youtube.com/embed/zCecE7OyVMU","https://encrypted-tbn0.gstatic.com/images?q=tbn:ANd9GcSaZZLwGXqiNU5rkhexU86wKZGzymZWTp2nKRDFdITh7rD7Jb6yGA",50,3.2,3458,1590,1868,"Morbi non lectus. Aliquam sit amet diam in magna bibendum imperdiet. Nullam orci pede, venenatis non, sodales sed, tincidunt eu, felis.",28,8135,44,4.9,5943,156,5787
711,"Quand je serai petit",1995,"https://www.youtube.com/embed/c4O-c4OycPM","https://encrypted-tbn0.gstatic.com/images?q=tbn:ANd9GcSfenuQRjGbddBAE4j3I_GN73Ch-EI9uairOfxWWbLQYAluLoDWCQ",98,2,2034,3118,-1084,"Donec diam neque, vestibulum eget, vulputate ut, ultrices vel, augue. Vestibulum ante ipsum primis in faucibus orci luctus et ultrices posuere cubilia Curae; Donec pharetra, magna vestibulum aliquet ultrices, erat tortor sollicitudin mi, sit amet lobortis sapien sapien non mi. Integer ac neque.",34,2789,77,4.6,2779,213,2566
712,"Aloft",2009,"https://www.youtube.com/embed/hvDwA_EDcOQ","https://encrypted-tbn0.gstatic.com/images?q=tbn:ANd9GcR203qZ3CqJHkReGO_urfLpOmRqqwbZ6g8ZOVV-2aZbySbWl_abdg",49,4.3,2777,1374,1403,"Suspendisse potenti. In eleifend quam a odio. In hac habitasse platea dictumst.",50,9431,36,6.3,7762,6885,877
713,"Poolboy: Drowning Out the Fury",2004,"https://www.youtube.com/embed/OWwVD1xdAX4","https://encrypted-tbn0.gstatic.com/images?q=tbn:ANd9GcTZmxe1lfZxGWCEdh5BIO8o0IWoInXoMB0QURL9yFrayrcsRK7J",65,2.9,2409,831,1578,"Aenean lectus. Pellentesque eget nunc. Donec quis orci eget orci vehicula condimentum.",64,3455,29,6.8,8410,47,8363
714,"Azumi 2: Death or Love",1996,"https://www.youtube.com/embed/7Yz10uCVNVk","https://encrypted-tbn0.gstatic.com/images?q=tbn:ANd9GcSigGMCEOHmqUMTkf9z3wcQTZlj2VM5cRueb-YgaX9_Hkej2qI5mQ",31,2.1,8446,2308,6138,"Cum sociis natoque penatibus et magnis dis parturient montes, nascetur ridiculus mus. Vivamus vestibulum sagittis sapien. Cum sociis natoque penatibus et magnis dis parturient montes, nascetur ridiculus mus.",70,2413,61,5.9,9683,627,9056
715,"Meet the Fockers",1997,"https://www.youtube.com/embed/zCecE7OyVMU","https://encrypted-tbn0.gstatic.com/images?q=tbn:ANd9GcQ4tG7BC0SE2SNUji4NBAmTKKl13L-IuMZpkiEbQm0YeWk9Z1SQUg",49,9.7,8437,831,7606,"Cum sociis natoque penatibus et magnis dis parturient montes, nascetur ridiculus mus. Vivamus vestibulum sagittis sapien. Cum sociis natoque penatibus et magnis dis parturient montes, nascetur ridiculus mus.",82,2840,81,6.2,9416,2001,7415
716,"Man Is Not a Bird (Covek nije tica)",2003,"https://www.youtube.com/embed/EKGATzNnr8c","https://encrypted-tbn0.gstatic.com/images?q=tbn:ANd9GcQ3liTMd9u-FOh16V1KslqpsRMQ7s9_8wAeiIkai8222SoHyIRe",82,9.3,7146,9584,-2438,"Quisque id justo sit amet sapien dignissim vestibulum. Vestibulum ante ipsum primis in faucibus orci luctus et ultrices posuere cubilia Curae; Nulla dapibus dolor vel est. Donec odio justo, sollicitudin ut, suscipit a, feugiat et, eros.",66,6719,80,1,5529,5471,58
717,"The Paradine Case",2011,"https://www.youtube.com/embed/tkSuLa3o_5A","https://encrypted-tbn0.gstatic.com/images?q=tbn:ANd9GcS_NoH0Aw_5YFsBFwfBPn_O7YPHXumI5V3iQ2s7B-3zPU_7sSm1gA",3,3.2,8446,2489,5957,"Quisque id justo sit amet sapien dignissim vestibulum. Vestibulum ante ipsum primis in faucibus orci luctus et ultrices posuere cubilia Curae; Nulla dapibus dolor vel est. Donec odio justo, sollicitudin ut, suscipit a, feugiat et, eros.",30,2822,18,9,3530,156,3374
718,"Hype!",2012,"https://www.youtube.com/embed/-6jCNhebfg8","https://encrypted-tbn0.gstatic.com/images?q=tbn:ANd9GcQj3o8UxHr9-tOcX5N5ppAE1Y9EZS5-9IYjKEogAzmsetJB5g0w",66,5.4,692,562,130,"Donec diam neque, vestibulum eget, vulputate ut, ultrices vel, augue. Vestibulum ante ipsum primis in faucibus orci luctus et ultrices posuere cubilia Curae; Donec pharetra, magna vestibulum aliquet ultrices, erat tortor sollicitudin mi, sit amet lobortis sapien sapien non mi. Integer ac neque.",82,7069,19,8.8,3801,2965,836
719,"7 Women (a.k.a. Seven Women)",2002,"https://www.youtube.com/embed/KbZ3TVEkuDY","https://encrypted-tbn0.gstatic.com/images?q=tbn:ANd9GcSxYkdQhkFdrUcKH8fJB2yXGC_mRCGuYTVOQUJTDJY0t9GQ7I2_",77,1.8,3890,4712,-822,"Proin eu mi. Nulla ac enim. In tempor, turpis nec euismod scelerisque, quam turpis adipiscing lorem, vitae mattis nibh ligula nec sem.",22,8013,70,1.8,692,2777,-2085
720,"Sky Fighters (Les Chevaliers Du Ciel)",2006,"https://www.youtube.com/embed/jEnIfGQ_UuQ","https://i.pinimg.com/736x/37/a0/99/37a099570abb65e478268af396315658--brochure-design-colour-combinations.jpg",98,6.9,4108,47,4061,"Praesent blandit. Nam nulla. Integer pede justo, lacinia eget, tincidunt eget, tempus vel, pede.",80,6593,77,9.7,2847,7462,-4615
721,"Overnight Delivery",1992,"https://www.youtube.com/embed/HwWWws3kzKg","https://encrypted-tbn0.gstatic.com/images?q=tbn:ANd9GcQoGIgMrMpVA2TiWG8g9ENb7x-ZrciYB-gqzjyCnG-C2EgT8ePfkA",98,9.5,6579,6885,-306,"Duis bibendum. Morbi non quam nec dui luctus rutrum. Nulla tellus.",58,9282,95,1.2,7162,1025,6137
722,"Breaking the Silence: Truth and Lies in the War on Terror",1996,"https://www.youtube.com/embed/VccwBGgyzP4","https://encrypted-tbn0.gstatic.com/images?q=tbn:ANd9GcQ1NxrNXukXKIzYZ8UbVazSnR-5741v5UDQPpMMVUvn_2I28fMZ",42,6.9,8454,3607,4847,"Cum sociis natoque penatibus et magnis dis parturient montes, nascetur ridiculus mus. Vivamus vestibulum sagittis sapien. Cum sociis natoque penatibus et magnis dis parturient montes, nascetur ridiculus mus.",70,7690,49,6.9,7890,3412,4478
723,"Dr. Jekyll and Ms. Hyde",2010,"https://www.youtube.com/embed/XtgCqMZofqM","https://encrypted-tbn0.gstatic.com/images?q=tbn:ANd9GcTiS27rf1ltLwxOAbTBhYvqJuvJG8ctIALtoknQh7MHlvV3r0UO",77,4.6,284,4860,-4576,"Cras non velit nec nisi vulputate nonummy. Maecenas tincidunt lacus at velit. Vivamus vel nulla eget eros elementum pellentesque.",32,510,26,3.1,5146,2198,2948
724,"Hype!",2004,"https://www.youtube.com/embed/IU3xV9ZRYlk","https://i.pinimg.com/236x/77/50/b3/7750b3ebe0787ae8e9beb7e2615e3b01.jpg",68,8.8,7900,73,7827,"Curabitur in libero ut massa volutpat convallis. Morbi odio odio, elementum eu, interdum eu, tincidunt in, leo. Maecenas pulvinar lobortis est.",54,9164,64,7.2,7162,562,6600
725,"Meet the Fockers",2011,"https://www.youtube.com/embed/vuzplFd3YVY","https://encrypted-tbn0.gstatic.com/images?q=tbn:ANd9GcQvLz9_jwOs-MucEN-bWUhjq9aaYyfVvyNoFoGgGFdFJBMuXq1yqw",19,1.8,692,218,474,"Sed ante. Vivamus tortor. Duis mattis egestas metus.",48,1528,22,6.7,8611,1545,7066
726,"Thunder Bay",1985,"https://www.youtube.com/embed/BQcvHEkGaEA","https://encrypted-tbn0.gstatic.com/images?q=tbn:ANd9GcT5qYZ7WL1XpLSuZms35fvGdxwAwN8ZoDje7zRyyFHfFSsWWAHelQ",19,6.8,8816,7659,1157,"Phasellus in felis. Donec semper sapien a libero. Nam dui.",72,3119,38,7.7,7890,6554,1336
727,"Confidence",2000,"https://www.youtube.com/embed/dfUJm6XgD7g","https://encrypted-tbn0.gstatic.com/images?q=tbn:ANd9GcQj3o8UxHr9-tOcX5N5ppAE1Y9EZS5-9IYjKEogAzmsetJB5g0w",70,9.3,9141,831,8310,"Morbi non lectus. Aliquam sit amet diam in magna bibendum imperdiet. Nullam orci pede, venenatis non, sodales sed, tincidunt eu, felis.",38,93,96,3.6,2777,361,2416
728,"Condorman",1992,"https://www.youtube.com/embed/2BoyDp49C6Y","https://encrypted-tbn0.gstatic.com/images?q=tbn:ANd9GcSf2dfgX6MEnaRNwWQSyRmKHm53LfBYmW9pJJCfqjE0BKijzycS",81,5.8,8377,7659,718,"Nulla ut erat id mauris vulputate elementum. Nullam varius. Nulla facilisi.",96,8567,17,9.1,5943,54,5889
729,"Digging Up the Marrow",2006,"https://www.youtube.com/embed/3svtRyLq3b0","https://encrypted-tbn0.gstatic.com/images?q=tbn:ANd9GcQhhglaTqXYejQ2b9TYl15F3E4pAgR1pWjyYyUTJgkHGuKsiWyHrw",44,7.7,9696,6885,2811,"Integer tincidunt ante vel ipsum. Praesent blandit lacinia erat. Vestibulum sed magna at nunc commodo placerat.",58,8838,36,3.2,2323,7219,-4896
730,"Condorman",1968,"https://www.youtube.com/embed/zCecE7OyVMU","https://encrypted-tbn0.gstatic.com/images?q=tbn:ANd9GcQ_K_OlRU89USb4Vi53WsTFwqiEXKhfRUVw08lWTiH5XSmSISDDwg",59,5.4,1795,4020,-2225,"Duis aliquam convallis nunc. Proin at turpis a pede posuere nonummy. Integer non velit.",80,6593,81,4.7,2847,3118,-271
731,"Vicky Donor",1987,"https://www.youtube.com/embed/ocWpGdITSR4","https://encrypted-tbn0.gstatic.com/images?q=tbn:ANd9GcTZlJW6ILTHoyypnMTvpWTFl3IhTXHYM5kQntofSVvdKEozMRsTxQ",82,3.6,4108,3371,737,"Suspendisse potenti. In eleifend quam a odio. In hac habitasse platea dictumst.",44,281,61,2.4,6774,7659,-885
732,"Beyond Therapy",1994,"https://www.youtube.com/embed/i6ilL5z6cjA","https://encrypted-tbn0.gstatic.com/images?q=tbn:ANd9GcQ-Bo62SqPu_RKYOfA9eW-LQjqldSZ02v2_G5-UJtSlr8Qd948lLA",70,1.8,8611,3771,4840,"Proin leo odio, porttitor id, consequat in, consequat ut, nulla. Sed accumsan felis. Ut at dolor quis odio consequat varius.",38,1317,49,4.6,753,213,540
733,"Gorko!",2008,"https://www.youtube.com/embed/iM8kaNCrnX0","https://encrypted-tbn0.gstatic.com/images?q=tbn:ANd9GcQT7MRD7KMXMfYFZ3Qi33LI-_bu1Q0DxOyhQgqolg06W2PrTbVuWg",70,3.2,7256,781,6475,"Maecenas leo odio, condimentum id, luctus nec, molestie sed, justo. Pellentesque viverra pede ac diam. Cras pellentesque volutpat dui.",70,223,82,3.2,753,4,749
734,"Poolboy: Drowning Out the Fury",1998,"https://www.youtube.com/embed/7C2Nad0aMPg","https://encrypted-tbn0.gstatic.com/images?q=tbn:ANd9GcSQ-QvEfMwKoUuWLDF2x2M1V4BTEN6-uoYrr8ShYvdSVQcHru6h",38,7.7,6175,54,6121,"Sed sagittis. Nam congue, risus semper porta volutpat, quam pede lobortis ligula, sit amet eleifend pede libero quis orci. Nullam molestie nibh in lectus.",36,4897,61,2.4,6774,1575,5199
735,"Iceberg, L'",2011,"https://www.youtube.com/embed/cENucEoMZic","https://encrypted-tbn0.gstatic.com/images?q=tbn:ANd9GcR6OdK3cVIVUn07PmO7zFQb1JyTfdi6L4FwxFWOD9dfwTwN4hEt",34,6.7,2987,7659,-4672,"Donec diam neque, vestibulum eget, vulputate ut, ultrices vel, augue. Vestibulum ante ipsum primis in faucibus orci luctus et ultrices posuere cubilia Curae; Donec pharetra, magna vestibulum aliquet ultrices, erat tortor sollicitudin mi, sit amet lobortis sapien sapien non mi. Integer ac neque.",100,1649,4,8.3,12,1025,-1013
736,"Dragon Ball Z the Movie: The World's Strongest (a.k.a. Dragon Ball Z: The Strongest Guy in The World) (Doragon bôru Z: Kono yo de ichiban tsuyoi yatsu)",2004,"https://www.youtube.com/embed/YVYzxm_RqMg","https://encrypted-tbn0.gstatic.com/images?q=tbn:ANd9GcS_NoH0Aw_5YFsBFwfBPn_O7YPHXumI5V3iQ2s7B-3zPU_7sSm1gA",35,5.1,2481,1592,889,"Curabitur in libero ut massa volutpat convallis. Morbi odio odio, elementum eu, interdum eu, tincidunt in, leo. Maecenas pulvinar lobortis est.",36,5941,18,9.7,692,1733,-1041
737,"From Beijing with Love",2004,"https://www.youtube.com/embed/PdL8kn_G5EQ","https://i.pinimg.com/236x/77/50/b3/7750b3ebe0787ae8e9beb7e2615e3b01.jpg",70,8.4,12,4124,-4112,"Quisque id justo sit amet sapien dignissim vestibulum. Vestibulum ante ipsum primis in faucibus orci luctus et ultrices posuere cubilia Curae; Nulla dapibus dolor vel est. Donec odio justo, sollicitudin ut, suscipit a, feugiat et, eros.",22,1636,87,4.1,12,176,-164
738,"Lust for Gold",2003,"https://www.youtube.com/embed/YVYzxm_RqMg","https://encrypted-tbn0.gstatic.com/images?q=tbn:ANd9GcQ-Bo62SqPu_RKYOfA9eW-LQjqldSZ02v2_G5-UJtSlr8Qd948lLA",83,1.5,7890,9584,-1694,"Proin leo odio, porttitor id, consequat in, consequat ut, nulla. Sed accumsan felis. Ut at dolor quis odio consequat varius.",54,9382,2,8.4,7146,8004,-858
739,"Thoroughly Modern Millie",2011,"https://www.youtube.com/embed/giIs-AEAX6Y","https://encrypted-tbn0.gstatic.com/images?q=tbn:ANd9GcSJJAS-aY5yM_o538SFwYJKMI1ICZvCAEdnVZX59tINRulVx7aBpA",70,2.4,9090,7219,1871,"Morbi non lectus. Aliquam sit amet diam in magna bibendum imperdiet. Nullam orci pede, venenatis non, sodales sed, tincidunt eu, felis.",58,223,66,2.1,6386,5206,1180
740,"The Indian Runner",2011,"https://www.youtube.com/embed/fPq4zW9QZSg","https://encrypted-tbn0.gstatic.com/images?q=tbn:ANd9GcTppyYABMyqegOc4I6b3NS0iUaX0R6Cy1-PlahMrPPUzzqPNux9Gg",56,1.8,3801,5209,-1408,"Quisque id justo sit amet sapien dignissim vestibulum. Vestibulum ante ipsum primis in faucibus orci luctus et ultrices posuere cubilia Curae; Nulla dapibus dolor vel est. Donec odio justo, sollicitudin ut, suscipit a, feugiat et, eros.",88,2629,38,6.7,2016,831,1185
741,"Harry Potter and the Order of the Phoenix",2010,"https://www.youtube.com/embed/OWwVD1xdAX4","http://pictify.saatchigallery.com/files/works/chagall-vitraux-pour-jerusalem-poster-chagall-la-tribu-de-1363528645.jpg",23,2.4,4286,7219,-2933,"Duis bibendum. Morbi non quam nec dui luctus rutrum. Nulla tellus.",96,1379,31,6.3,6755,1822,4933
742,"7 Women (a.k.a. Seven Women)",1996,"https://www.youtube.com/embed/_aHDqS8EMn0","https://encrypted-tbn0.gstatic.com/images?q=tbn:ANd9GcQN3_I47i-MkaTBmK9e2PzNkhGoJsWeB5U_dn5cat3hDSHLCPjU",6,1.1,7576,6366,1210,"Integer ac leo. Pellentesque ultrices mattis odio. Donec vitae nisi.",44,93,22,1,3458,4712,-1254
743,"Sgt. Bilko",1995,"https://www.youtube.com/embed/hvDwA_EDcOQ","https://encrypted-tbn0.gstatic.com/images?q=tbn:ANd9GcQ06LkOABmCBkCQO4wr6V0tHNUOyUYNR-YLaEHAblZo1ZqlooBmOg",64,6,5696,4125,1571,"Maecenas ut massa quis augue luctus tincidunt. Nulla mollis molestie lorem. Quisque ut erat.",50,9282,81,4.8,8611,3607,5004
744,"The Possession of Michael King",2005,"https://www.youtube.com/embed/oNTzFnMXT3E","https://encrypted-tbn0.gstatic.com/images?q=tbn:ANd9GcSfdl_pNap7w4wYTP7dhiozrcmHAmCcADuvkKlsj19tBpxYkq60LA",34,9.1,6469,923,5546,"Nulla ut erat id mauris vulputate elementum. Nullam varius. Nulla facilisi.",44,2789,25,6.8,2016,213,1803
745,"The Browning Version",2011,"https://www.youtube.com/embed/DyQ8PoBV_Vo","https://encrypted-tbn0.gstatic.com/images?q=tbn:ANd9GcSC_qEbYtBeELogQVPTeiWNRbcOXlYKbMYmMPaG67T_yrWKEiTV",55,2.8,2779,3527,-748,"Cum sociis natoque penatibus et magnis dis parturient montes, nascetur ridiculus mus. Vivamus vestibulum sagittis sapien. Cum sociis natoque penatibus et magnis dis parturient montes, nascetur ridiculus mus.",88,8485,80,5.1,9683,1037,8646
746,"Thunder Bay",2006,"https://www.youtube.com/embed/SF0w2B6DNUE","https://encrypted-tbn0.gstatic.com/images?q=tbn:ANd9GcSC_qEbYtBeELogQVPTeiWNRbcOXlYKbMYmMPaG67T_yrWKEiTV",80,5.1,7393,5515,1878,"Cras non velit nec nisi vulputate nonummy. Maecenas tincidunt lacus at velit. Vivamus vel nulla eget eros elementum pellentesque.",52,1442,80,9.5,8496,3118,5378
747,"Isolation",1968,"https://www.youtube.com/embed/oP-fRX_gB6o","https://encrypted-tbn0.gstatic.com/images?q=tbn:ANd9GcToWUNrpDN1sKiQrTBrAPVZaaHkjYWkdwsMh5Igburh2w20IPRs",70,5.8,2269,1741,528,"Morbi non lectus. Aliquam sit amet diam in magna bibendum imperdiet. Nullam orci pede, venenatis non, sodales sed, tincidunt eu, felis.",58,962,6,1,8816,1983,6833
748,"Fido",1965,"https://www.youtube.com/embed/uaTAhjdaEuY","https://encrypted-tbn0.gstatic.com/images?q=tbn:ANd9GcRboE_Oz4pmq_fbkSzc09GrZ6-FxQU9Zh64Y6b3LNLomLOlE4VEzQ",26,3.8,6869,176,6693,"Lorem ipsum dolor sit amet, consectetuer adipiscing elit. Proin risus. Praesent lectus.",26,962,30,3.4,6734,361,6373
749,"The Innocent",2010,"https://www.youtube.com/embed/fkr_djVWStU","https://encrypted-tbn0.gstatic.com/images?q=tbn:ANd9GcSf2dfgX6MEnaRNwWQSyRmKHm53LfBYmW9pJJCfqjE0BKijzycS",42,7.7,132,2001,-1869,"Proin eu mi. Nulla ac enim. In tempor, turpis nec euismod scelerisque, quam turpis adipiscing lorem, vitae mattis nibh ligula nec sem.",80,6159,69,3.2,3890,2777,1113
750,"Thoroughly Modern Millie",1993,"https://www.youtube.com/embed/YoBOCxBq88A","https://encrypted-tbn0.gstatic.com/images?q=tbn:ANd9GcTZmxe1lfZxGWCEdh5BIO8o0IWoInXoMB0QURL9yFrayrcsRK7J",89,9.5,7383,6892,491,"Maecenas ut massa quis augue luctus tincidunt. Nulla mollis molestie lorem. Quisque ut erat.",88,7702,26,3.2,9585,73,9512
751,"Zatoichi the Outlaw (Zatôichi rôyaburi) (Zatôichi 16)",2000,"https://www.youtube.com/embed/KbZ3TVEkuDY","https://encrypted-tbn0.gstatic.com/images?q=tbn:ANd9GcToWUNrpDN1sKiQrTBrAPVZaaHkjYWkdwsMh5Igburh2w20IPRs",38,6.2,7162,2596,4566,"Praesent blandit. Nam nulla. Integer pede justo, lacinia eget, tincidunt eget, tempus vel, pede.",22,4185,43,1.2,7146,1214,5932
752,"Hype!",1998,"https://www.youtube.com/embed/DIOW-kR_ams","https://encrypted-tbn0.gstatic.com/images?q=tbn:ANd9GcTTLFfQrJmhvXjL4d_udm6Z89QYglVi4hTEmbaDRdDoqHQsaQVg",49,3.8,9994,218,9776,"Phasellus in felis. Donec semper sapien a libero. Nam dui.",80,6770,33,9.3,753,9584,-8831
753,"The Land Before Time XII: The Great Day of the Flyers",2008,"https://www.youtube.com/embed/zCecE7OyVMU","https://encrypted-tbn0.gstatic.com/images?q=tbn:ANd9GcQzrbGfcJ8GKN78hn-r1fcQf4zH81e0MlsuOddkBJvhC5RvfF2DNw",34,8.3,6072,225,5847,"Proin eu mi. Nulla ac enim. In tempor, turpis nec euismod scelerisque, quam turpis adipiscing lorem, vitae mattis nibh ligula nec sem.",66,8567,88,1.7,2847,5,2842
754,"The Big Trail",2010,"https://www.youtube.com/embed/VccwBGgyzP4","https://encrypted-tbn0.gstatic.com/images?q=tbn:ANd9GcRauFfIne8mHbF9MCn-LxY8C6gHqalPefcj6s8z0B9JZwEnD5A4",17,3.2,2883,7462,-4579,"Cras non velit nec nisi vulputate nonummy. Maecenas tincidunt lacus at velit. Vivamus vel nulla eget eros elementum pellentesque.",42,1882,28,3.2,8382,2198,6184
755,"Block-Heads",2007,"https://www.youtube.com/embed/oNTzFnMXT3E","https://encrypted-tbn0.gstatic.com/images?q=tbn:ANd9GcSkjHflFbGJwA3Dk6FW71ynZ5C6z_y9dkcX7Q0Q-2NSkRIUerlH",4,2.1,8454,263,8191,"Proin eu mi. Nulla ac enim. In tempor, turpis nec euismod scelerisque, quam turpis adipiscing lorem, vitae mattis nibh ligula nec sem.",42,6858,65,2.4,5541,6427,-886
756,"Dorado, El",1979,"https://www.youtube.com/embed/tkSuLa3o_5A","https://encrypted-tbn0.gstatic.com/images?q=tbn:ANd9GcTjDxlkO4SurlCq11A009Vm2yOW0XT4x5GHflg-pkVrTiqWURnydg",31,6.7,3530,3444,86,"Aliquam quis turpis eget elit sodales scelerisque. Mauris sit amet eros. Suspendisse accumsan tortor quis turpis.",86,6673,37,1.8,2481,285,2196
757,"Man Is Not a Bird (Covek nije tica)",2001,"https://www.youtube.com/embed/dfUJm6XgD7g","https://encrypted-tbn0.gstatic.com/images?q=tbn:ANd9GcSaZZLwGXqiNU5rkhexU86wKZGzymZWTp2nKRDFdITh7rD7Jb6yGA",4,5.1,2034,1575,459,"Maecenas ut massa quis augue luctus tincidunt. Nulla mollis molestie lorem. Quisque ut erat.",30,93,10,6.9,6801,562,6239
758,"The Browning Version",2005,"https://www.youtube.com/embed/MpJEOpsVWtA","https://encrypted-tbn0.gstatic.com/images?q=tbn:ANd9GcTZlJW6ILTHoyypnMTvpWTFl3IhTXHYM5kQntofSVvdKEozMRsTxQ",6,8.4,5704,1898,3806,"Sed sagittis. Nam congue, risus semper porta volutpat, quam pede lobortis ligula, sit amet eleifend pede libero quis orci. Nullam molestie nibh in lectus.",62,1528,57,8.4,6662,4860,1802
759,"The Possession of Michael King",2003,"https://www.youtube.com/embed/1ywA8TtwJ50","https://encrypted-tbn0.gstatic.com/images?q=tbn:ANd9GcTZlJW6ILTHoyypnMTvpWTFl3IhTXHYM5kQntofSVvdKEozMRsTxQ",78,1.2,2795,1983,812,"Cum sociis natoque penatibus et magnis dis parturient montes, nascetur ridiculus mus. Vivamus vestibulum sagittis sapien. Cum sociis natoque penatibus et magnis dis parturient montes, nascetur ridiculus mus.",30,8234,22,4.2,3411,361,3050
760,"Dragon Ball Z the Movie: The World's Strongest (a.k.a. Dragon Ball Z: The Strongest Guy in The World) (Doragon bôru Z: Kono yo de ichiban tsuyoi yatsu)",1992,"https://www.youtube.com/embed/HwWWws3kzKg","https://encrypted-tbn0.gstatic.com/images?q=tbn:ANd9GcQ1NxrNXukXKIzYZ8UbVazSnR-5741v5UDQPpMMVUvn_2I28fMZ",89,1.7,8437,1545,6892,"Curabitur in libero ut massa volutpat convallis. Morbi odio odio, elementum eu, interdum eu, tincidunt in, leo. Maecenas pulvinar lobortis est.",60,8567,57,5.8,6774,7462,-688
761,"Wing and a Prayer",1965,"https://www.youtube.com/embed/iM8kaNCrnX0","https://encrypted-tbn0.gstatic.com/images?q=tbn:ANd9GcQN3_I47i-MkaTBmK9e2PzNkhGoJsWeB5U_dn5cat3hDSHLCPjU",36,5.1,8454,3648,4806,"Nam ultrices, libero non mattis pulvinar, nulla pede ullamcorper augue, a suscipit nulla elit ac nulla. Sed vel enim sit amet nunc viverra dapibus. Nulla suscipit ligula in lacus.",74,6868,23,6,7383,562,6821
762,"The Sword of Doom",1988,"https://www.youtube.com/embed/YVYzxm_RqMg","https://encrypted-tbn0.gstatic.com/images?q=tbn:ANd9GcRboE_Oz4pmq_fbkSzc09GrZ6-FxQU9Zh64Y6b3LNLomLOlE4VEzQ",88,3.1,3605,1741,1864,"Pellentesque at nulla. Suspendisse potenti. Cras in purus eu magna vulputate luctus.",48,1882,89,8.4,9416,1592,7824
763,"Man Is Not a Bird (Covek nije tica)",2003,"https://www.youtube.com/embed/yuYoFVHkvIA","https://encrypted-tbn0.gstatic.com/images?q=tbn:ANd9GcSigGMCEOHmqUMTkf9z3wcQTZlj2VM5cRueb-YgaX9_Hkej2qI5mQ",2,6.8,2323,305,2018,"Proin interdum mauris non ligula pellentesque ultrices. Phasellus id sapien in sapien iaculis congue. Vivamus metus arcu, adipiscing molestie, hendrerit at, vulputate vitae, nisl.",62,6858,82,3.2,2777,831,1946
764,"Vicky Donor",1994,"https://www.youtube.com/embed/VccwBGgyzP4","https://encrypted-tbn0.gstatic.com/images?q=tbn:ANd9GcSsoy4iP--KOCJ5pPhAcbfrQSvWLPYPI3I557hNf2Vfb6OrfrOczg",98,4.9,9994,831,9163,"In congue. Etiam justo. Etiam pretium iaculis justo.",28,8065,10,6.1,2883,2489,394
765,"Fair Game",2005,"https://www.youtube.com/embed/keo8PJecIEc","https://encrypted-tbn0.gstatic.com/images?q=tbn:ANd9GcTZlJW6ILTHoyypnMTvpWTFl3IhTXHYM5kQntofSVvdKEozMRsTxQ",56,3.1,6774,2999,3775,"Praesent blandit. Nam nulla. Integer pede justo, lacinia eget, tincidunt eget, tempus vel, pede.",96,2866,61,5.7,2269,573,1696
766,"The Innocent",1993,"https://www.youtube.com/embed/REXXOGV1IIE","https://encrypted-tbn0.gstatic.com/images?q=tbn:ANd9GcRfaybDSA3hF-btWMAObj0lbtp7UbFPvvC41dZ9EEL1BMISwxF6",34,1,3890,6494,-2604,"Quisque porta volutpat erat. Quisque erat eros, viverra eget, congue eget, semper rutrum, nulla. Nunc purus.",82,1836,56,5.9,6386,831,5555
767,"American Pie Presents The Naked Mile (American Pie 5: The Naked Mile)",2011,"https://www.youtube.com/embed/-6jCNhebfg8","https://encrypted-tbn0.gstatic.com/images?q=tbn:ANd9GcS0uoN_00qCw12_q1GgGAdcbA-6sp6JzFguYZMxLObI8Ydh9OBk",56,9.6,3019,4712,-1693,"Nam ultrices, libero non mattis pulvinar, nulla pede ullamcorper augue, a suscipit nulla elit ac nulla. Sed vel enim sit amet nunc viverra dapibus. Nulla suscipit ligula in lacus.",58,3455,23,1.7,5696,2965,2731
768,"Little Giants",2011,"https://www.youtube.com/embed/hvDwA_EDcOQ","https://encrypted-tbn0.gstatic.com/images?q=tbn:ANd9GcQ-Bo62SqPu_RKYOfA9eW-LQjqldSZ02v2_G5-UJtSlr8Qd948lLA",3,8.9,4108,2489,1619,"Cras non velit nec nisi vulputate nonummy. Maecenas tincidunt lacus at velit. Vivamus vel nulla eget eros elementum pellentesque.",38,2153,66,1.8,8429,537,7892
769,"The Last Seduction",2003,"https://www.youtube.com/embed/3svtRyLq3b0","https://encrypted-tbn0.gstatic.com/images?q=tbn:ANd9GcSYy4S-T_nbr708KkpYcV-RgmyX_MPtCXzFVr44X7S9CAQsyQAE3Q",19,6.8,2323,2777,-454,"Lorem ipsum dolor sit amet, consectetuer adipiscing elit. Proin risus. Praesent lectus.",28,8065,64,4.8,8446,3428,5018
770,"From Beijing with Love",2009,"https://www.youtube.com/embed/2FbDY0MeJf8","https://encrypted-tbn0.gstatic.com/images?q=tbn:ANd9GcRWaaeSy6yTdILVOdHiDa9DWFAM4DhQ1JlJvUBR4vWbVoeZznD-",17,1,284,3771,-3487,"Fusce posuere felis sed lacus. Morbi sem mauris, laoreet ut, rhoncus aliquet, pulvinar sed, nisl. Nunc rhoncus dui vel sem.",74,2435,17,8.9,6469,305,6164
771,"Rabid Grannies (Mémés cannibales, Les)",2011,"https://www.youtube.com/embed/B12REtkl2KY","https://encrypted-tbn0.gstatic.com/images?q=tbn:ANd9GcSJJAS-aY5yM_o538SFwYJKMI1ICZvCAEdnVZX59tINRulVx7aBpA",26,4.6,6006,3648,2358,"Suspendisse potenti. In eleifend quam a odio. In hac habitasse platea dictumst.",26,2476,36,4.6,7576,9584,-2008
772,"7 Women (a.k.a. Seven Women)",2003,"https://www.youtube.com/embed/iW3t_wUDG5U","https://encrypted-tbn0.gstatic.com/images?q=tbn:ANd9GcToWUNrpDN1sKiQrTBrAPVZaaHkjYWkdwsMh5Igburh2w20IPRs",42,4.9,1360,5206,-3846,"Cras non velit nec nisi vulputate nonummy. Maecenas tincidunt lacus at velit. Vivamus vel nulla eget eros elementum pellentesque.",80,281,70,5.1,2987,7462,-4475
773,"In the Line of Duty: The F.B.I. Murders",2012,"https://www.youtube.com/embed/THq6KlWgiqw","https://encrypted-tbn0.gstatic.com/images?q=tbn:ANd9GcTZmxe1lfZxGWCEdh5BIO8o0IWoInXoMB0QURL9yFrayrcsRK7J",11,3.2,1555,573,982,"Integer ac leo. Pellentesque ultrices mattis odio. Donec vitae nisi.",70,3074,22,6.8,3624,2596,1028
774,"The Poseidon Adventure",1997,"https://www.youtube.com/embed/hgBj5b1TTDQ","https://encrypted-tbn0.gstatic.com/images?q=tbn:ANd9GcTiS27rf1ltLwxOAbTBhYvqJuvJG8ctIALtoknQh7MHlvV3r0UO",43,6.9,6662,1374,5288,"Integer ac leo. Pellentesque ultrices mattis odio. Donec vitae nisi.",88,4897,2,3.6,198,263,-65
775,"Another Woman",2004,"https://www.youtube.com/embed/COTt1zvBUJk","https://encrypted-tbn0.gstatic.com/images?q=tbn:ANd9GcQLt0-lz7NK5w-_elA1XCxyK77lQX2-JBVeEkkOx2aJ8RjYYqE4Vw",38,4.2,132,1983,-1851,"Maecenas leo odio, condimentum id, luctus nec, molestie sed, justo. Pellentesque viverra pede ac diam. Cras pellentesque volutpat dui.",50,1631,82,6.8,3890,3251,639
776,"Meet the Fockers",1999,"https://www.youtube.com/embed/2FbDY0MeJf8","https://encrypted-tbn0.gstatic.com/images?q=tbn:ANd9GcSnUCe3jwoe6TiIdg0tv_j25Q3WHNDjeBfzqlYhOl70hy95_k9t1Q",25,3.6,5954,2311,3643,"Curabitur in libero ut massa volutpat convallis. Morbi odio odio, elementum eu, interdum eu, tincidunt in, leo. Maecenas pulvinar lobortis est.",40,9178,59,1.5,5943,7219,-1276
777,"Aloft",1997,"https://www.youtube.com/embed/cYAtvv-wopk","https://encrypted-tbn0.gstatic.com/images?q=tbn:ANd9GcSigGMCEOHmqUMTkf9z3wcQTZlj2VM5cRueb-YgaX9_Hkej2qI5mQ",13,3.2,9389,2308,7081,"Phasellus sit amet erat. Nulla tempus. Vivamus in felis eu sapien cursus vestibulum.",100,4907,38,1.8,698,1037,-339
778,"Jin Roh: The Wolf Brigade (Jin-Rô)",2005,"https://www.youtube.com/embed/sZ8e_0i7UDk","https://encrypted-tbn0.gstatic.com/images?q=tbn:ANd9GcRZ2qgbwUkZMB6Z3KUBla8OIzYNOBzMaNpoAeNofRYZj8V27vwD",77,6.8,3019,3563,-544,"Quisque id justo sit amet sapien dignissim vestibulum. Vestibulum ante ipsum primis in faucibus orci luctus et ultrices posuere cubilia Curae; Nulla dapibus dolor vel est. Donec odio justo, sollicitudin ut, suscipit a, feugiat et, eros.",36,607,7,6.8,8446,2999,5447
779,"Blow Out",1996,"https://www.youtube.com/embed/PdL8kn_G5EQ","https://encrypted-tbn0.gstatic.com/images?q=tbn:ANd9GcRboE_Oz4pmq_fbkSzc09GrZ6-FxQU9Zh64Y6b3LNLomLOlE4VEzQ",68,5.1,6579,4196,2383,"Morbi porttitor lorem id ligula. Suspendisse ornare consequat lectus. In est risus, auctor sed, tristique in, tempus sit amet, sem.",38,3444,89,6,9822,3527,6295
780,"Fido",2006,"https://www.youtube.com/embed/eAIjuMHKEiA","https://encrypted-tbn0.gstatic.com/images?q=tbn:ANd9GcT11kibbY7ZQKvhvKatIRRKfv-n-n77Ve-QuVdMOoMg-fol_k9j",64,7.5,1795,4,1791,"Integer ac leo. Pellentesque ultrices mattis odio. Donec vitae nisi.",22,7498,26,9.5,2779,3563,-784
781,"Alive",2005,"https://www.youtube.com/embed/cYAtvv-wopk","https://encrypted-tbn0.gstatic.com/images?q=tbn:ANd9GcSxYkdQhkFdrUcKH8fJB2yXGC_mRCGuYTVOQUJTDJY0t9GQ7I2_",88,6.3,7146,8964,-1818,"Aliquam quis turpis eget elit sodales scelerisque. Mauris sit amet eros. Suspendisse accumsan tortor quis turpis.",50,4828,38,9.3,7256,1590,5666
782,"Dragon Ball Z the Movie: The World's Strongest (a.k.a. Dragon Ball Z: The Strongest Guy in The World) (Doragon bôru Z: Kono yo de ichiban tsuyoi yatsu)",2007,"https://www.youtube.com/embed/MpJEOpsVWtA","https://encrypted-tbn0.gstatic.com/images?q=tbn:ANd9GcTZlJW6ILTHoyypnMTvpWTFl3IhTXHYM5kQntofSVvdKEozMRsTxQ",57,3.6,6199,54,6145,"Suspendisse potenti. In eleifend quam a odio. In hac habitasse platea dictumst.",28,6113,26,9.6,2269,215,2054
783,"Little Nikita",2012,"https://www.youtube.com/embed/dfUJm6XgD7g","https://encrypted-tbn0.gstatic.com/images?q=tbn:ANd9GcSi9aOrS5oPJ7A3vLqJaEpNsmPCxVAYNwpoAl_G9K7p6pLBjaxALw",98,2.9,9683,1741,7942,"Mauris enim leo, rhoncus sed, vestibulum sit amet, cursus id, turpis. Integer aliquet, massa id lobortis convallis, tortor risus dapibus augue, vel accumsan tellus nisi eu orci. Mauris lacinia sapien quis libero.",26,6777,56,8.3,8715,2311,6404
784,"Transylvania",1992,"https://www.youtube.com/embed/6Ui6m_eEEOI","https://encrypted-tbn0.gstatic.com/images?q=tbn:ANd9GcQInYhbERWHKRlaq1eJAqZqaGQ9zndtpCyGofdPFToPGHuZUGCS",59,3.2,6734,3539,3195,"Mauris enim leo, rhoncus sed, vestibulum sit amet, cursus id, turpis. Integer aliquet, massa id lobortis convallis, tortor risus dapibus augue, vel accumsan tellus nisi eu orci. Mauris lacinia sapien quis libero.",58,4828,44,2.4,2777,3771,-994
785,"The Long Voyage Home",1999,"https://www.youtube.com/embed/7C2Nad0aMPg","https://i.pinimg.com/736x/37/a0/99/37a099570abb65e478268af396315658--brochure-design-colour-combinations.jpg",88,9.5,8816,3421,5395,"In congue. Etiam justo. Etiam pretium iaculis justo.",50,6719,78,9.1,5541,3118,2423
786,"Bullet",1992,"https://www.youtube.com/embed/SF0w2B6DNUE","https://encrypted-tbn0.gstatic.com/images?q=tbn:ANd9GcT11kibbY7ZQKvhvKatIRRKfv-n-n77Ve-QuVdMOoMg-fol_k9j",89,7.7,7383,3074,4309,"In sagittis dui vel nisl. Duis ac nibh. Fusce lacus purus, aliquet at, feugiat non, pretium quis, lectus.",74,2682,30,4.2,8429,2311,6118
787,"Beyond Therapy",2011,"https://www.youtube.com/embed/l-u3PdA-rpY","https://encrypted-tbn0.gstatic.com/images?q=tbn:ANd9GcTt-58zOD-K4oKQ0AbvYduMdi-NxFRYLjx9Maf9ECQJMZkvfanqUw",61,1.8,3923,6892,-2969,"Proin eu mi. Nulla ac enim. In tempor, turpis nec euismod scelerisque, quam turpis adipiscing lorem, vitae mattis nibh ligula nec sem.",38,223,50,5.7,8446,8629,-183
788,"U2: Rattle and Hum",2004,"https://www.youtube.com/embed/_aHDqS8EMn0","https://encrypted-tbn0.gstatic.com/images?q=tbn:ANd9GcRqaaKELSsRKJh2pc05f1s5ksCTCIa-bgxbzGUm2T7leAI2nlTqZw",61,5.9,6006,54,5952,"Proin leo odio, porttitor id, consequat in, consequat ut, nulla. Sed accumsan felis. Ut at dolor quis odio consequat varius.",88,6113,34,8.9,4324,1865,2459
789,"Harry Potter and the Order of the Phoenix",1997,"https://www.youtube.com/embed/MNp1LPm3Krs","https://encrypted-tbn0.gstatic.com/images?q=tbn:ANd9GcT3yd_NJLFNa8pH2NX8GufmbmYJmY751UxjTNcB2ALIMGhKfx94gQ",17,3.1,3458,2308,1150,"Proin eu mi. Nulla ac enim. In tempor, turpis nec euismod scelerisque, quam turpis adipiscing lorem, vitae mattis nibh ligula nec sem.",80,9885,81,1.1,5146,305,4841
790,"Digging Up the Marrow",2010,"https://www.youtube.com/embed/dfUJm6XgD7g","https://encrypted-tbn0.gstatic.com/images?q=tbn:ANd9GcQ1NxrNXukXKIzYZ8UbVazSnR-5741v5UDQPpMMVUvn_2I28fMZ",75,4.2,4286,2489,1797,"Sed ante. Vivamus tortor. Duis mattis egestas metus.",82,1589,65,3.2,6469,6554,-85
791,"Another Woman",2008,"https://www.youtube.com/embed/PdL8kn_G5EQ","https://i.pinimg.com/originals/c9/ba/74/c9ba7451301a9003752d2f61b5036730.jpg",28,9.5,8382,573,7809,"Curabitur at ipsum ac tellus semper interdum. Mauris ullamcorper purus sit amet nulla. Quisque arcu libero, rutrum ac, lobortis vel, dapibus at, diam.",62,9178,84,9.7,7256,923,6333
792,"U2: Rattle and Hum",2006,"https://www.youtube.com/embed/iW3t_wUDG5U","https://encrypted-tbn0.gstatic.com/images?q=tbn:ANd9GcSaZZLwGXqiNU5rkhexU86wKZGzymZWTp2nKRDFdITh7rD7Jb6yGA",87,8.8,8226,7659,567,"Integer tincidunt ante vel ipsum. Praesent blandit lacinia erat. Vestibulum sed magna at nunc commodo placerat.",72,4799,28,2.4,9994,1983,8011
793,"Dorado, El",1988,"https://www.youtube.com/embed/dfUJm6XgD7g","https://encrypted-tbn0.gstatic.com/images?q=tbn:ANd9GcQX7g7WDTuGnT2syPcShrXK1gFJn4uMaACeAnWvesheIZXX58K1",23,1.2,5704,8004,-2300,"Lorem ipsum dolor sit amet, consectetuer adipiscing elit. Proin risus. Praesent lectus.",70,7592,68,7.8,6869,7659,-790
794,"Gorko!",2000,"https://www.youtube.com/embed/_c3WIprIGHE","https://encrypted-tbn0.gstatic.com/images?q=tbn:ANd9GcTppyYABMyqegOc4I6b3NS0iUaX0R6Cy1-PlahMrPPUzzqPNux9Gg",83,1.8,8410,3881,4529,"Fusce consequat. Nulla nisl. Nunc nisl.",26,6858,66,5.7,3624,573,3051
795,"The Story of Xinghua",1997,"https://www.youtube.com/embed/l-u3PdA-rpY","https://encrypted-tbn0.gstatic.com/images?q=tbn:ANd9GcRJqLpbXoWWpbGuNXVAuF8Iy2X8EFCKx-z2jPdj5XGEL_wrFgzY",77,9.6,9090,5,9085,"Integer ac leo. Pellentesque ultrices mattis odio. Donec vitae nisi.",100,8363,22,1.5,9683,1865,7818
796,"Miami Vice",1985,"https://www.youtube.com/embed/sZ8e_0i7UDk","https://encrypted-tbn0.gstatic.com/images?q=tbn:ANd9GcT4OdTRV0WhSYFs5jcy1IZYf9s7DjJToLKAVXlTv4GhzQcgmD-C",62,2.4,6662,3563,3099,"Vestibulum ac est lacinia nisi venenatis tristique. Fusce congue, diam id ornare imperdiet, sapien urna pretium nisl, ut volutpat sapien arcu sed augue. Aliquam erat volutpat.",26,6113,98,6.2,9696,1504,8192
797,"Iceberg, L'",1992,"https://www.youtube.com/embed/8oTXc5t35Ro","https://encrypted-tbn0.gstatic.com/images?q=tbn:ANd9GcSAeZgM34QBLW9W6aAQ7xBcJIa1KwtfVVcFHkKpsxvOjDBmNvh0",28,9.5,5529,176,5353,"Quisque porta volutpat erat. Quisque erat eros, viverra eget, congue eget, semper rutrum, nulla. Nunc purus.",62,223,28,8.8,5696,7659,-1963
798,"Azumi 2: Death or Love",1999,"https://www.youtube.com/embed/oNTzFnMXT3E","https://encrypted-tbn0.gstatic.com/images?q=tbn:ANd9GcRfaybDSA3hF-btWMAObj0lbtp7UbFPvvC41dZ9EEL1BMISwxF6",48,8.1,6579,1560,5019,"Praesent id massa id nisl venenatis lacinia. Aenean sit amet justo. Morbi ut odio.",86,7702,6,6.9,5146,6427,-1281
799,"Blow Out",1999,"https://www.youtube.com/embed/MPWMBITCudM","https://encrypted-tbn0.gstatic.com/images?q=tbn:ANd9GcQLt0-lz7NK5w-_elA1XCxyK77lQX2-JBVeEkkOx2aJ8RjYYqE4Vw",50,2.1,8816,781,8035,"Quisque id justo sit amet sapien dignissim vestibulum. Vestibulum ante ipsum primis in faucibus orci luctus et ultrices posuere cubilia Curae; Nulla dapibus dolor vel est. Donec odio justo, sollicitudin ut, suscipit a, feugiat et, eros.",76,2413,83,3.2,8454,47,8407
800,"Aloft",1997,"https://www.youtube.com/embed/DIOW-kR_ams","https://encrypted-tbn0.gstatic.com/images?q=tbn:ANd9GcQvfJ-vLQ5TK13ND8sY6H-r6cm_4f3SnW_WAWn2vuX-nGh6F8JquQ",89,2.1,2016,3648,-1632,"Nam ultrices, libero non mattis pulvinar, nulla pede ullamcorper augue, a suscipit nulla elit ac nulla. Sed vel enim sit amet nunc viverra dapibus. Nulla suscipit ligula in lacus.",70,8838,3,1.8,1191,4860,-3669
801,"Meet the Fockers",1985,"https://www.youtube.com/embed/h-k0-Z9b4Cw","https://encrypted-tbn0.gstatic.com/images?q=tbn:ANd9GcTpzv6ZkKQ_5fFlx242_ZFGnV3MuzyUBrlVMhbcTFBKJGCr7XxS",98,4.1,2883,1025,1858,"Suspendisse potenti. In eleifend quam a odio. In hac habitasse platea dictumst.",82,8056,31,9.3,7900,1496,6404
802,"Breaking the Silence: Truth and Lies in the War on Terror",1994,"https://www.youtube.com/embed/DIOW-kR_ams","https://encrypted-tbn0.gstatic.com/images?q=tbn:ANd9GcQ5LAO-oqK_jHF33R_asKWptHCRYc_456jcsgrngpU6q8htwl24",70,5.9,7683,2198,5485,"Fusce consequat. Nulla nisl. Nunc nisl.",70,7498,41,9.5,1360,879,481
803,"Digging Up the Marrow",1997,"https://www.youtube.com/embed/KbZ3TVEkuDY","https://i.pinimg.com/236x/77/50/b3/7750b3ebe0787ae8e9beb7e2615e3b01.jpg",6,2.8,8388,7219,1169,"In sagittis dui vel nisl. Duis ac nibh. Fusce lacus purus, aliquet at, feugiat non, pretium quis, lectus.",28,8363,33,8.3,7146,1545,5601
804,"The Possession of Michael King",2010,"https://www.youtube.com/embed/IU3xV9ZRYlk","https://encrypted-tbn0.gstatic.com/images?q=tbn:ANd9GcSfenuQRjGbddBAE4j3I_GN73Ch-EI9uairOfxWWbLQYAluLoDWCQ",56,4.1,9389,1898,7491,"Quisque id justo sit amet sapien dignissim vestibulum. Vestibulum ante ipsum primis in faucibus orci luctus et ultrices posuere cubilia Curae; Nulla dapibus dolor vel est. Donec odio justo, sollicitudin ut, suscipit a, feugiat et, eros.",80,223,81,8.3,9994,2965,7029
805,"The Indian Runner",2010,"https://www.youtube.com/embed/3_bUymlkSuA","http://pictify.saatchigallery.com/files/works/chagall-vitraux-pour-jerusalem-poster-chagall-la-tribu-de-1363528645.jpg",37,7.7,3411,73,3338,"In sagittis dui vel nisl. Duis ac nibh. Fusce lacus purus, aliquet at, feugiat non, pretium quis, lectus.",42,8838,88,1.2,2034,1061,973
806,"Meet the Fockers",1997,"https://www.youtube.com/embed/zCecE7OyVMU","https://encrypted-tbn0.gstatic.com/images?q=tbn:ANd9GcSmZDfgAQh9gNhDHM4YtECFcKd6iXDTMrn-PXI6Wylc9Lddn5ah-w",62,9.5,3923,831,3092,"Donec diam neque, vestibulum eget, vulputate ut, ultrices vel, augue. Vestibulum ante ipsum primis in faucibus orci luctus et ultrices posuere cubilia Curae; Donec pharetra, magna vestibulum aliquet ultrices, erat tortor sollicitudin mi, sit amet lobortis sapien sapien non mi. Integer ac neque.",44,9805,62,5.9,6275,305,5970
807,"The Pit, the Pendulum and Hope",2010,"https://www.youtube.com/embed/VUEaDUyeTR8","https://encrypted-tbn0.gstatic.com/images?q=tbn:ANd9GcSJJAS-aY5yM_o538SFwYJKMI1ICZvCAEdnVZX59tINRulVx7aBpA",66,3.6,9822,6885,2937,"Phasellus sit amet erat. Nulla tempus. Vivamus in felis eu sapien cursus vestibulum.",22,6858,3,4.3,7146,3563,3583
808,"Wing and a Prayer",1985,"https://www.youtube.com/embed/REXXOGV1IIE","https://images-na.ssl-images-amazon.com/images/I/41SFojuU1FL._SY600_.jpg",26,1.2,6469,3251,3218,"Vestibulum quam sapien, varius ut, blandit non, interdum in, ante. Vestibulum ante ipsum primis in faucibus orci luctus et ultrices posuere cubilia Curae; Duis faucibus accumsan odio. Curabitur convallis.",70,9382,41,9.6,2034,3648,-1614
809,"King Kong",1995,"https://www.youtube.com/embed/6Ui6m_eEEOI","https://encrypted-tbn0.gstatic.com/images?q=tbn:ANd9GcQ6bssTSRlLtGI7nwGNoiKWx9hXXrZsIq1bCgawmuzsVpmbrHCZ3g",87,2.1,5529,1575,3954,"Donec diam neque, vestibulum eget, vulputate ut, ultrices vel, augue. Vestibulum ante ipsum primis in faucibus orci luctus et ultrices posuere cubilia Curae; Donec pharetra, magna vestibulum aliquet ultrices, erat tortor sollicitudin mi, sit amet lobortis sapien sapien non mi. Integer ac neque.",26,8647,31,5.1,1360,1025,335
810,"7 Women (a.k.a. Seven Women)",1999,"https://www.youtube.com/embed/fkr_djVWStU","https://encrypted-tbn0.gstatic.com/images?q=tbn:ANd9GcRUlnvuLTJg0mT65nGxwZY6OfVvev6DxlvShy5w5Mpai-i6Vk6Qfg",96,2.4,6275,2999,3276,"Pellentesque at nulla. Suspendisse potenti. Cras in purus eu magna vulputate luctus.",26,2840,30,9.3,692,9584,-8892
811,"The King",2009,"https://www.youtube.com/embed/7C2Nad0aMPg","https://encrypted-tbn0.gstatic.com/images?q=tbn:ANd9GcSi9aOrS5oPJ7A3vLqJaEpNsmPCxVAYNwpoAl_G9K7p6pLBjaxALw",23,7,9585,156,9429,"Suspendisse potenti. In eleifend quam a odio. In hac habitasse platea dictumst.",56,3444,55,8.4,1555,2999,-1444
812,"Hardcore",2007,"https://www.youtube.com/embed/oNTzFnMXT3E","https://encrypted-tbn0.gstatic.com/images?q=tbn:ANd9GcRXW_MDHretVBvFBnfeqtLtE86uQkY-GTeOH_gP8OZY1Znu6a86qg",55,1.2,8446,4196,4250,"In sagittis dui vel nisl. Duis ac nibh. Fusce lacus purus, aliquet at, feugiat non, pretium quis, lectus.",86,7498,84,7.7,753,4020,-3267
813,"Level Five",2010,"https://www.youtube.com/embed/tkSuLa3o_5A","https://encrypted-tbn0.gstatic.com/images?q=tbn:ANd9GcQoGIgMrMpVA2TiWG8g9ENb7x-ZrciYB-gqzjyCnG-C2EgT8ePfkA",56,3.4,4324,1037,3287,"Praesent blandit. Nam nulla. Integer pede justo, lacinia eget, tincidunt eget, tempus vel, pede.",40,2840,30,3.2,8496,4860,3636
814,"Little Boy Blue",2007,"https://www.youtube.com/embed/RyYFAqJFYdE","https://encrypted-tbn0.gstatic.com/images?q=tbn:ANd9GcQ6bssTSRlLtGI7nwGNoiKWx9hXXrZsIq1bCgawmuzsVpmbrHCZ3g",18,4.2,6072,1733,4339,"Proin eu mi. Nulla ac enim. In tempor, turpis nec euismod scelerisque, quam turpis adipiscing lorem, vitae mattis nibh ligula nec sem.",26,2629,75,3.6,8377,1037,7340
815,"Aloft",1997,"https://www.youtube.com/embed/fPq4zW9QZSg","https://encrypted-tbn0.gstatic.com/images?q=tbn:ANd9GcRWaaeSy6yTdILVOdHiDa9DWFAM4DhQ1JlJvUBR4vWbVoeZznD-",22,9.7,6869,156,6713,"Maecenas tristique, est et tempus semper, est quam pharetra magna, ac consequat metus sapien ut nunc. Vestibulum ante ipsum primis in faucibus orci luctus et ultrices posuere cubilia Curae; Mauris viverra diam vitae quam. Suspendisse potenti.",80,2667,26,6,3923,4020,-97
816,"Jin Roh: The Wolf Brigade (Jin-Rô)",2005,"https://www.youtube.com/embed/YVYzxm_RqMg","https://encrypted-tbn0.gstatic.com/images?q=tbn:ANd9GcQInYhbERWHKRlaq1eJAqZqaGQ9zndtpCyGofdPFToPGHuZUGCS",96,8.3,8377,5209,3168,"Morbi non lectus. Aliquam sit amet diam in magna bibendum imperdiet. Nullam orci pede, venenatis non, sodales sed, tincidunt eu, felis.",66,962,98,4.9,6469,361,6108
817,"Breaking the Silence: Truth and Lies in the War on Terror",1997,"https://www.youtube.com/embed/tkSuLa3o_5A","https://encrypted-tbn0.gstatic.com/images?q=tbn:ANd9GcQInYhbERWHKRlaq1eJAqZqaGQ9zndtpCyGofdPFToPGHuZUGCS",88,2.1,3801,3771,30,"Maecenas leo odio, condimentum id, luctus nec, molestie sed, justo. Pellentesque viverra pede ac diam. Cras pellentesque volutpat dui.",32,4828,98,8.5,9899,361,9538
818,"AVPR: Aliens vs. Predator - Requiem",1993,"https://www.youtube.com/embed/oNTzFnMXT3E","https://encrypted-tbn0.gstatic.com/images?q=tbn:ANd9GcSRkE8RSex-89LA2Msfb1Vq6eH047lvDYppmp9IwK2zLgw2nbE-Uw",81,1.1,9683,2198,7485,"Proin leo odio, porttitor id, consequat in, consequat ut, nulla. Sed accumsan felis. Ut at dolor quis odio consequat varius.",42,4185,66,1.1,7383,156,7227
819,"The Iran Job",2005,"https://www.youtube.com/embed/RyYFAqJFYdE","https://encrypted-tbn0.gstatic.com/images?q=tbn:ANd9GcSkjHflFbGJwA3Dk6FW71ynZ5C6z_y9dkcX7Q0Q-2NSkRIUerlH",66,4.4,4324,1560,2764,"Pellentesque at nulla. Suspendisse potenti. Cras in purus eu magna vulputate luctus.",66,2413,55,9,7146,2352,4794
820,"Azumi 2: Death or Love",2007,"https://www.youtube.com/embed/REXXOGV1IIE","https://encrypted-tbn0.gstatic.com/images?q=tbn:ANd9GcSBKrAU7qHXZ_vqij5HmW3xvTgSZ9qA7lT4fxAsUEXHGvWHHXai",3,4.1,2409,1214,1195,"Sed sagittis. Nam congue, risus semper porta volutpat, quam pede lobortis ligula, sit amet eleifend pede libero quis orci. Nullam molestie nibh in lectus.",68,2435,28,6.2,2733,213,2520
821,"Beyond Therapy",1996,"https://www.youtube.com/embed/6W0KFTj50zI","https://encrypted-tbn0.gstatic.com/images?q=tbn:ANd9GcSC_qEbYtBeELogQVPTeiWNRbcOXlYKbMYmMPaG67T_yrWKEiTV",57,5.4,6869,2965,3904,"Donec diam neque, vestibulum eget, vulputate ut, ultrices vel, augue. Vestibulum ante ipsum primis in faucibus orci luctus et ultrices posuere cubilia Curae; Donec pharetra, magna vestibulum aliquet ultrices, erat tortor sollicitudin mi, sit amet lobortis sapien sapien non mi. Integer ac neque.",30,8065,22,2.1,6801,285,6516
822,"Fair Game",1997,"https://www.youtube.com/embed/LcepHRTWI18","https://encrypted-tbn0.gstatic.com/images?q=tbn:ANd9GcTppyYABMyqegOc4I6b3NS0iUaX0R6Cy1-PlahMrPPUzzqPNux9Gg",50,3.6,9899,1590,8309,"Fusce consequat. Nulla nisl. Nunc nisl.",50,9683,66,5.8,8377,73,8304
823,"U2: Rattle and Hum",2000,"https://www.youtube.com/embed/VUEaDUyeTR8","https://encrypted-tbn0.gstatic.com/images?q=tbn:ANd9GcQj3o8UxHr9-tOcX5N5ppAE1Y9EZS5-9IYjKEogAzmsetJB5g0w",95,6.2,6469,285,6184,"Quisque porta volutpat erat. Quisque erat eros, viverra eget, congue eget, semper rutrum, nulla. Nunc purus.",28,694,55,2.4,6579,1575,5004
824,"Little Nikita",2001,"https://www.youtube.com/embed/hvDwA_EDcOQ","https://encrypted-tbn0.gstatic.com/images?q=tbn:ANd9GcSBKrAU7qHXZ_vqij5HmW3xvTgSZ9qA7lT4fxAsUEXHGvWHHXai",78,9.3,8446,2965,5481,"Integer tincidunt ante vel ipsum. Praesent blandit lacinia erat. Vestibulum sed magna at nunc commodo placerat.",88,5002,35,8.4,5696,285,5411
825,"The Tic Code",2011,"https://www.youtube.com/embed/8W6yYBAUxv4","https://encrypted-tbn0.gstatic.com/images?q=tbn:ANd9GcT8fsnqcp8Y3Y2dxkM4H8TJyS7bRYttijiNFZ-mruoqpzO29uM7",13,2,2323,2001,322,"Mauris enim leo, rhoncus sed, vestibulum sit amet, cursus id, turpis. Integer aliquet, massa id lobortis convallis, tortor risus dapibus augue, vel accumsan tellus nisi eu orci. Mauris lacinia sapien quis libero.",70,7690,41,3.4,8454,772,7682
826,"The Sword of Doom",2011,"https://www.youtube.com/embed/eqDHqOcXjRQ","https://encrypted-tbn0.gstatic.com/images?q=tbn:ANd9GcSsoy4iP--KOCJ5pPhAcbfrQSvWLPYPI3I557hNf2Vfb6OrfrOczg",77,8.3,118,772,-654,"Cum sociis natoque penatibus et magnis dis parturient montes, nascetur ridiculus mus. Vivamus vestibulum sagittis sapien. Cum sociis natoque penatibus et magnis dis parturient montes, nascetur ridiculus mus.",62,7702,40,4.6,5954,1592,4362
827,"Jin Roh: The Wolf Brigade (Jin-Rô)",2007,"https://www.youtube.com/embed/iW3t_wUDG5U","https://encrypted-tbn0.gstatic.com/images?q=tbn:ANd9GcSAeZgM34QBLW9W6aAQ7xBcJIa1KwtfVVcFHkKpsxvOjDBmNvh0",59,2.8,2269,4860,-2591,"Sed sagittis. Nam congue, risus semper porta volutpat, quam pede lobortis ligula, sit amet eleifend pede libero quis orci. Nullam molestie nibh in lectus.",56,8567,65,4.6,6869,54,6815
828,"The Big Trail",2001,"https://www.youtube.com/embed/4AEkzL2SvmI","https://encrypted-tbn0.gstatic.com/images?q=tbn:ANd9GcQtbFBdNfjGVCo1GPJC_9PUkUc7wRIwwh0PMwS76SEP_QTtAyat",80,3.4,3019,1504,1515,"Fusce posuere felis sed lacus. Morbi sem mauris, laoreet ut, rhoncus aliquet, pulvinar sed, nisl. Nunc rhoncus dui vel sem.",50,694,26,6.2,753,4860,-4107
829,"Rabid Grannies (Mémés cannibales, Les)",1997,"https://www.youtube.com/embed/6SO96lvWqzc","https://i.pinimg.com/236x/5f/f6/69/5ff6693c3694f55e8ed9738084c4c6b1--d-design-design-concepts.jpg",60,6.8,1360,1025,335,"Vestibulum ac est lacinia nisi venenatis tristique. Fusce congue, diam id ornare imperdiet, sapien urna pretium nisl, ut volutpat sapien arcu sed augue. Aliquam erat volutpat.",56,2866,4,2.8,9899,2617,7282
830,"Azumi 2: Death or Love",1997,"https://www.youtube.com/embed/ee12SvnnrSw","https://encrypted-tbn0.gstatic.com/images?q=tbn:ANd9GcSBKrAU7qHXZ_vqij5HmW3xvTgSZ9qA7lT4fxAsUEXHGvWHHXai",77,9.1,2777,176,2601,"Fusce posuere felis sed lacus. Morbi sem mauris, laoreet ut, rhoncus aliquet, pulvinar sed, nisl. Nunc rhoncus dui vel sem.",30,7481,13,9,3801,2777,1024
831,"Clifford",2011,"https://www.youtube.com/embed/G9T_f7DjYho","https://encrypted-tbn0.gstatic.com/images?q=tbn:ANd9GcQ1RC08Lpg31X2H7K5Uphlh7PGrzq7-JtVNzeSh-4UIh-JZbUaCDg",4,5.7,284,4860,-4576,"In congue. Etiam justo. Etiam pretium iaculis justo.",62,4897,77,2.1,284,3074,-2790
832,"All These Women (För att inte tala om alla dessa kvinnor)",1985,"https://www.youtube.com/embed/1roy4o4tqQM","https://encrypted-tbn0.gstatic.com/images?q=tbn:ANd9GcQvfJ-vLQ5TK13ND8sY6H-r6cm_4f3SnW_WAWn2vuX-nGh6F8JquQ",75,4.8,6175,3428,2747,"Quisque porta volutpat erat. Quisque erat eros, viverra eget, congue eget, semper rutrum, nulla. Nunc purus.",26,1836,95,4.8,5542,1374,4168
833,"Fair Game",2005,"https://www.youtube.com/embed/COTt1zvBUJk","https://encrypted-tbn0.gstatic.com/images?q=tbn:ANd9GcSQ-QvEfMwKoUuWLDF2x2M1V4BTEN6-uoYrr8ShYvdSVQcHru6h",70,8.3,5943,3444,2499,"Donec diam neque, vestibulum eget, vulputate ut, ultrices vel, augue. Vestibulum ante ipsum primis in faucibus orci luctus et ultrices posuere cubilia Curae; Donec pharetra, magna vestibulum aliquet ultrices, erat tortor sollicitudin mi, sit amet lobortis sapien sapien non mi. Integer ac neque.",98,7690,70,5.9,2269,5471,-3202
834,"Elvis Meets Nixon",1977,"https://www.youtube.com/embed/vuzplFd3YVY","https://encrypted-tbn0.gstatic.com/images?q=tbn:ANd9GcSYy4S-T_nbr708KkpYcV-RgmyX_MPtCXzFVr44X7S9CAQsyQAE3Q",36,1.2,3458,9584,-6126,"Quisque porta volutpat erat. Quisque erat eros, viverra eget, congue eget, semper rutrum, nulla. Nunc purus.",58,1631,7,1.4,4108,1592,2516
835,"The Sword of Doom",2011,"https://www.youtube.com/embed/nMVDQZ34joY","https://encrypted-tbn0.gstatic.com/images?q=tbn:ANd9GcS5gl0DLTFbt7bYHEmtfUaWEKVmT1jfD8Td6ILXO_YOKSFekX9e",30,4.1,3890,305,3585,"In congue. Etiam justo. Etiam pretium iaculis justo.",58,4869,87,9.6,7256,2965,4291
836,"Talcum Powder",1986,"https://www.youtube.com/embed/iW3t_wUDG5U","https://encrypted-tbn0.gstatic.com/images?q=tbn:ANd9GcQN3_I47i-MkaTBmK9e2PzNkhGoJsWeB5U_dn5cat3hDSHLCPjU",34,3.2,8429,1733,6696,"Integer tincidunt ante vel ipsum. Praesent blandit lacinia erat. Vestibulum sed magna at nunc commodo placerat.",72,1948,10,4.8,2847,1545,1302
837,"Breaking the Silence: Truth and Lies in the War on Terror",1968,"https://www.youtube.com/embed/cENucEoMZic","https://encrypted-tbn0.gstatic.com/images?q=tbn:ANd9GcSigGMCEOHmqUMTkf9z3wcQTZlj2VM5cRueb-YgaX9_Hkej2qI5mQ",64,1.8,9683,573,9110,"Praesent blandit. Nam nulla. Integer pede justo, lacinia eget, tincidunt eget, tempus vel, pede.",62,6770,26,3.2,1795,3881,-2086
838,"Card Subject To Change",1996,"https://www.youtube.com/embed/cENucEoMZic","https://encrypted-tbn0.gstatic.com/images?q=tbn:ANd9GcRJqLpbXoWWpbGuNXVAuF8Iy2X8EFCKx-z2jPdj5XGEL_wrFgzY",6,5.7,3530,1733,1797,"Nam ultrices, libero non mattis pulvinar, nulla pede ullamcorper augue, a suscipit nulla elit ac nulla. Sed vel enim sit amet nunc viverra dapibus. Nulla suscipit ligula in lacus.",34,5941,43,8.4,3411,3074,337
839,"Overnight Delivery",1994,"https://www.youtube.com/embed/mAX1oGLvMAA","http://pictify.saatchigallery.com/files/works/chagall-vitraux-pour-jerusalem-poster-chagall-la-tribu-de-1363528645.jpg",82,3.9,5954,781,5173,"Pellentesque at nulla. Suspendisse potenti. Cras in purus eu magna vulputate luctus.",80,6868,4,5.9,8611,5284,3327
840,"Thunder Bay",2011,"https://www.youtube.com/embed/nMVDQZ34joY","https://encrypted-tbn0.gstatic.com/images?q=tbn:ANd9GcSaZZLwGXqiNU5rkhexU86wKZGzymZWTp2nKRDFdITh7rD7Jb6yGA",84,3.2,5704,627,5077,"Phasellus sit amet erat. Nulla tempus. Vivamus in felis eu sapien cursus vestibulum.",76,9441,23,1.8,2733,3118,-385
841,"Gorko!",2002,"https://www.youtube.com/embed/jEnIfGQ_UuQ","https://encrypted-tbn0.gstatic.com/images?q=tbn:ANd9GcR6OdK3cVIVUn07PmO7zFQb1JyTfdi6L4FwxFWOD9dfwTwN4hEt",34,5.1,3890,5515,-1625,"Maecenas ut massa quis augue luctus tincidunt. Nulla mollis molestie lorem. Quisque ut erat.",96,93,66,3.9,2733,3563,-830
842,"Elvis Meets Nixon",2011,"https://www.youtube.com/embed/8W6yYBAUxv4","https://encrypted-tbn0.gstatic.com/images?q=tbn:ANd9GcQtbFBdNfjGVCo1GPJC_9PUkUc7wRIwwh0PMwS76SEP_QTtAyat",24,9.1,8377,772,7605,"Donec diam neque, vestibulum eget, vulputate ut, ultrices vel, augue. Vestibulum ante ipsum primis in faucibus orci luctus et ultrices posuere cubilia Curae; Donec pharetra, magna vestibulum aliquet ultrices, erat tortor sollicitudin mi, sit amet lobortis sapien sapien non mi. Integer ac neque.",28,9683,49,5.7,3411,4125,-714
843,"Sky Fighters (Les Chevaliers Du Ciel)",2010,"https://www.youtube.com/embed/DyQ8PoBV_Vo","https://encrypted-tbn0.gstatic.com/images?q=tbn:ANd9GcRxLYJSuzc9AAuuJ3R1HulbKM_T8_whdwPZQj7VyYonHOME6fYq",69,9,8382,4125,4257,"Aenean lectus. Pellentesque eget nunc. Donec quis orci eget orci vehicula condimentum.",38,735,56,2.4,8816,2352,6464
844,"Quand je serai petit",1994,"https://www.youtube.com/embed/wKvOud9GcRQ","https://encrypted-tbn0.gstatic.com/images?q=tbn:ANd9GcSQ-QvEfMwKoUuWLDF2x2M1V4BTEN6-uoYrr8ShYvdSVQcHru6h",98,2.9,6662,8004,-1342,"Nam ultrices, libero non mattis pulvinar, nulla pede ullamcorper augue, a suscipit nulla elit ac nulla. Sed vel enim sit amet nunc viverra dapibus. Nulla suscipit ligula in lacus.",96,4828,57,6.9,8301,5515,2786
845,"Another Woman",2003,"https://www.youtube.com/embed/mAX1oGLvMAA","https://encrypted-tbn0.gstatic.com/images?q=tbn:ANd9GcQLt0-lz7NK5w-_elA1XCxyK77lQX2-JBVeEkkOx2aJ8RjYYqE4Vw",6,3.4,7900,2311,5589,"In congue. Etiam justo. Etiam pretium iaculis justo.",96,4869,59,5.4,7146,2352,4794
846,"Dorado, El",1997,"https://www.youtube.com/embed/3_bUymlkSuA","https://encrypted-tbn0.gstatic.com/images?q=tbn:ANd9GcQ-Bo62SqPu_RKYOfA9eW-LQjqldSZ02v2_G5-UJtSlr8Qd948lLA",90,3.1,8496,1822,6674,"Vestibulum quam sapien, varius ut, blandit non, interdum in, ante. Vestibulum ante ipsum primis in faucibus orci luctus et ultrices posuere cubilia Curae; Duis faucibus accumsan odio. Curabitur convallis.",32,4526,65,1.8,2987,1025,1962
847,"Thunder Bay",1987,"https://www.youtube.com/embed/hvDwA_EDcOQ","https://i.pinimg.com/236x/5f/f6/69/5ff6693c3694f55e8ed9738084c4c6b1--d-design-design-concepts.jpg",26,3.2,5541,5515,26,"Cum sociis natoque penatibus et magnis dis parturient montes, nascetur ridiculus mus. Vivamus vestibulum sagittis sapien. Cum sociis natoque penatibus et magnis dis parturient montes, nascetur ridiculus mus.",66,1528,95,6.7,5542,1504,4038
848,"The Poseidon Adventure",2011,"https://www.youtube.com/embed/hvDwA_EDcOQ","https://encrypted-tbn0.gstatic.com/images?q=tbn:ANd9GcRqaaKELSsRKJh2pc05f1s5ksCTCIa-bgxbzGUm2T7leAI2nlTqZw",36,2.1,6275,213,6062,"Fusce consequat. Nulla nisl. Nunc nisl.",62,8363,17,3.2,2269,2198,71
849,"Of Love and Shadows",1985,"https://www.youtube.com/embed/SF0w2B6DNUE","https://encrypted-tbn0.gstatic.com/images?q=tbn:ANd9GcSnUCe3jwoe6TiIdg0tv_j25Q3WHNDjeBfzqlYhOl70hy95_k9t1Q",89,9.6,9416,1592,7824,"Maecenas tristique, est et tempus semper, est quam pharetra magna, ac consequat metus sapien ut nunc. Vestibulum ante ipsum primis in faucibus orci luctus et ultrices posuere cubilia Curae; Mauris viverra diam vitae quam. Suspendisse potenti.",62,3441,2,5.7,9496,3607,5889
850,"Thunder Bay",1992,"https://www.youtube.com/embed/uaTAhjdaEuY","https://encrypted-tbn0.gstatic.com/images?q=tbn:ANd9GcTTLFfQrJmhvXjL4d_udm6Z89QYglVi4hTEmbaDRdDoqHQsaQVg",98,2.9,7393,305,7088,"Integer tincidunt ante vel ipsum. Praesent blandit lacinia erat. Vestibulum sed magna at nunc commodo placerat.",64,1528,23,2.8,5542,1061,4481
851,"Card Subject To Change",2007,"https://www.youtube.com/embed/XtgCqMZofqM","https://encrypted-tbn0.gstatic.com/images?q=tbn:ANd9GcQtbFBdNfjGVCo1GPJC_9PUkUc7wRIwwh0PMwS76SEP_QTtAyat",89,1.8,7162,1822,5340,"Cras non velit nec nisi vulputate nonummy. Maecenas tincidunt lacus at velit. Vivamus vel nulla eget eros elementum pellentesque.",56,2822,94,8.8,6734,7659,-925
852,"King Kong",2005,"https://www.youtube.com/embed/9g-j4wuEOPo","https://encrypted-tbn0.gstatic.com/images?q=tbn:ANd9GcQ06LkOABmCBkCQO4wr6V0tHNUOyUYNR-YLaEHAblZo1ZqlooBmOg",45,1.2,5542,3428,2114,"Cras non velit nec nisi vulputate nonummy. Maecenas tincidunt lacus at velit. Vivamus vel nulla eget eros elementum pellentesque.",30,25,98,1.1,8446,2198,6248
853,"The Pit, the Pendulum and Hope",2011,"https://www.youtube.com/embed/hvDwA_EDcOQ","https://encrypted-tbn0.gstatic.com/images?q=tbn:ANd9GcQ5LAO-oqK_jHF33R_asKWptHCRYc_456jcsgrngpU6q8htwl24",56,3.4,6734,5228,1506,"Proin eu mi. Nulla ac enim. In tempor, turpis nec euismod scelerisque, quam turpis adipiscing lorem, vitae mattis nibh ligula nec sem.",96,3444,7,8.3,198,5206,-5008
854,"Thunder Bay",1999,"https://www.youtube.com/embed/VccwBGgyzP4","https://images-na.ssl-images-amazon.com/images/I/41SFojuU1FL._SY600_.jpg",29,8.4,4108,4020,88,"Cras mi pede, malesuada in, imperdiet et, commodo vulputate, justo. In blandit ultrices enim. Lorem ipsum dolor sit amet, consectetuer adipiscing elit.",42,5537,95,2.1,7162,54,7108
855,"Operation 'Y' & Other Shurik's Adventures",2000,"https://www.youtube.com/embed/sZ8e_0i7UDk","https://encrypted-tbn0.gstatic.com/images?q=tbn:ANd9GcQ5LAO-oqK_jHF33R_asKWptHCRYc_456jcsgrngpU6q8htwl24",22,3.8,7383,2308,5075,"Maecenas leo odio, condimentum id, luctus nec, molestie sed, justo. Pellentesque viverra pede ac diam. Cras pellentesque volutpat dui.",86,1631,10,4.6,1191,2001,-810
856,"Coming Down the Mountain",2008,"https://www.youtube.com/embed/keo8PJecIEc","https://encrypted-tbn0.gstatic.com/images?q=tbn:ANd9GcRWaaeSy6yTdILVOdHiDa9DWFAM4DhQ1JlJvUBR4vWbVoeZznD-",26,2.4,3417,361,3056,"Cras mi pede, malesuada in, imperdiet et, commodo vulputate, justo. In blandit ultrices enim. Lorem ipsum dolor sit amet, consectetuer adipiscing elit.",82,7702,88,5.4,753,6494,-5741
857,"The King",2001,"https://www.youtube.com/embed/6Ui6m_eEEOI","https://encrypted-tbn0.gstatic.com/images?q=tbn:ANd9GcRauFfIne8mHbF9MCn-LxY8C6gHqalPefcj6s8z0B9JZwEnD5A4",70,6.7,1795,263,1532,"Suspendisse potenti. In eleifend quam a odio. In hac habitasse platea dictumst.",22,2789,30,7,8446,1214,7232
858,"Prince Valiant",2011,"https://www.youtube.com/embed/Rc3e0m6SpXo","https://encrypted-tbn0.gstatic.com/images?q=tbn:ANd9GcRUlnvuLTJg0mT65nGxwZY6OfVvev6DxlvShy5w5Mpai-i6Vk6Qfg",82,3.8,8496,8629,-133,"Sed sagittis. Nam congue, risus semper porta volutpat, quam pede lobortis ligula, sit amet eleifend pede libero quis orci. Nullam molestie nibh in lectus.",26,1631,70,1.5,3923,562,3361
859,"Escaflowne: The Movie (Escaflowne)",1997,"https://www.youtube.com/embed/iW3t_wUDG5U","https://encrypted-tbn0.gstatic.com/images?q=tbn:ANd9GcQX7g7WDTuGnT2syPcShrXK1gFJn4uMaACeAnWvesheIZXX58K1",80,8.1,9696,5228,4468,"Integer ac leo. Pellentesque ultrices mattis odio. Donec vitae nisi.",44,25,26,3.9,2733,781,1952
860,"Man Is Not a Bird (Covek nije tica)",2004,"https://www.youtube.com/embed/B12REtkl2KY","https://encrypted-tbn0.gstatic.com/images?q=tbn:ANd9GcSkjHflFbGJwA3Dk6FW71ynZ5C6z_y9dkcX7Q0Q-2NSkRIUerlH",61,9.7,2323,156,2167,"Suspendisse potenti. In eleifend quam a odio. In hac habitasse platea dictumst.",30,2789,9,1,2016,781,1235
861,"Card Subject To Change",1996,"https://www.youtube.com/embed/l-u3PdA-rpY","https://encrypted-tbn0.gstatic.com/images?q=tbn:ANd9GcTlHaTq59e08Zugqn9ZX71XQYUOtuUGEQ9Mkl_HR1NmuSBceL7O",26,9.5,7715,73,7642,"Quisque porta volutpat erat. Quisque erat eros, viverra eget, congue eget, semper rutrum, nulla. Nunc purus.",76,2840,36,1.5,3890,5471,-1581
862,"Little Nikita",1999,"https://www.youtube.com/embed/ocWpGdITSR4","https://encrypted-tbn0.gstatic.com/images?q=tbn:ANd9GcS_NoH0Aw_5YFsBFwfBPn_O7YPHXumI5V3iQ2s7B-3zPU_7sSm1gA",22,9.6,6275,5515,760,"Praesent blandit. Nam nulla. Integer pede justo, lacinia eget, tincidunt eget, tempus vel, pede.",42,8363,17,9.3,7576,1741,5835
863,"The Indian Runner",2001,"https://www.youtube.com/embed/i6ilL5z6cjA","https://encrypted-tbn0.gstatic.com/images?q=tbn:ANd9GcSkP7ePajJciblvooQK7qTSV2J0ZdjBzPxrRi7NvBHdmOLYWeT4",96,6.3,3801,4860,-1059,"Aliquam quis turpis eget elit sodales scelerisque. Mauris sit amet eros. Suspendisse accumsan tortor quis turpis.",84,4252,22,5.1,3019,156,2863
864,"Quand je serai petit",2000,"https://www.youtube.com/embed/THq6KlWgiqw","https://encrypted-tbn0.gstatic.com/images?q=tbn:ANd9GcRboE_Oz4pmq_fbkSzc09GrZ6-FxQU9Zh64Y6b3LNLomLOlE4VEzQ",44,1.2,7683,2617,5066,"Pellentesque at nulla. Suspendisse potenti. Cras in purus eu magna vulputate luctus.",40,4828,49,5.9,7576,3607,3969
865,"Protector (Protektor)",1997,"https://www.youtube.com/embed/9g-j4wuEOPo","https://i.pinimg.com/236x/5f/f6/69/5ff6693c3694f55e8ed9738084c4c6b1--d-design-design-concepts.jpg",34,8.4,7256,7219,37,"Proin eu mi. Nulla ac enim. In tempor, turpis nec euismod scelerisque, quam turpis adipiscing lorem, vitae mattis nibh ligula nec sem.",26,9683,66,5.1,3801,4124,-323
866,"Isolation",1989,"https://www.youtube.com/embed/PdL8kn_G5EQ","https://encrypted-tbn0.gstatic.com/images?q=tbn:ANd9GcQ--11hFR6GYIOagDhcOJiqKSIqKz7XB_wRhQklbSwf9d4k8lto",6,2.9,2987,2198,789,"Donec diam neque, vestibulum eget, vulputate ut, ultrices vel, augue. Vestibulum ante ipsum primis in faucibus orci luctus et ultrices posuere cubilia Curae; Donec pharetra, magna vestibulum aliquet ultrices, erat tortor sollicitudin mi, sit amet lobortis sapien sapien non mi. Integer ac neque.",30,1379,18,5.1,198,2606,-2408
867,"The Long Voyage Home",2012,"https://www.youtube.com/embed/G9T_f7DjYho","https://encrypted-tbn0.gstatic.com/images?q=tbn:ANd9GcTpzv6ZkKQ_5fFlx242_ZFGnV3MuzyUBrlVMhbcTFBKJGCr7XxS",94,1.5,2034,3563,-1529,"Proin interdum mauris non ligula pellentesque ultrices. Phasellus id sapien in sapien iaculis congue. Vivamus metus arcu, adipiscing molestie, hendrerit at, vulputate vitae, nisl.",96,4828,31,9.5,8446,2443,6003
868,"Gunday",1997,"https://www.youtube.com/embed/G9T_f7DjYho","https://encrypted-tbn0.gstatic.com/images?q=tbn:ANd9GcTlHaTq59e08Zugqn9ZX71XQYUOtuUGEQ9Mkl_HR1NmuSBceL7O",61,1.1,5541,1037,4504,"Curabitur in libero ut massa volutpat convallis. Morbi odio odio, elementum eu, interdum eu, tincidunt in, leo. Maecenas pulvinar lobortis est.",26,1631,30,4.3,3458,305,3153
869,"Jin Roh: The Wolf Brigade (Jin-Rô)",2011,"https://www.youtube.com/embed/EKGATzNnr8c","https://encrypted-tbn0.gstatic.com/images?q=tbn:ANd9GcSi9aOrS5oPJ7A3vLqJaEpNsmPCxVAYNwpoAl_G9K7p6pLBjaxALw",6,1.5,5160,1545,3615,"Praesent id massa id nisl venenatis lacinia. Aenean sit amet justo. Morbi ut odio.",58,9683,60,8.4,9416,537,8879
870,"Joe Kidd",1991,"https://www.youtube.com/embed/OWwVD1xdAX4","https://encrypted-tbn0.gstatic.com/images?q=tbn:ANd9GcT5qYZ7WL1XpLSuZms35fvGdxwAwN8ZoDje7zRyyFHfFSsWWAHelQ",66,5.1,5146,1983,3163,"Cras non velit nec nisi vulputate nonummy. Maecenas tincidunt lacus at velit. Vivamus vel nulla eget eros elementum pellentesque.",22,1636,70,1,6869,1374,5495
871,"Coming Down the Mountain",2010,"https://www.youtube.com/embed/wKvOud9GcRQ","https://encrypted-tbn0.gstatic.com/images?q=tbn:ANd9GcRxLYJSuzc9AAuuJ3R1HulbKM_T8_whdwPZQj7VyYonHOME6fYq",17,9.6,6199,1374,4825,"Fusce consequat. Nulla nisl. Nunc nisl.",50,5410,29,7,9141,1374,7767
872,"The Last Seduction",1989,"https://www.youtube.com/embed/REXXOGV1IIE","https://encrypted-tbn0.gstatic.com/images?q=tbn:ANd9GcTrBuPeRIXbqvHjWMwFg1aZvVkw71rsNVla5A067w7kiY-DPB7N",34,4.2,9090,361,8729,"Fusce posuere felis sed lacus. Morbi sem mauris, laoreet ut, rhoncus aliquet, pulvinar sed, nisl. Nunc rhoncus dui vel sem.",82,4185,66,2.1,8429,285,8144
873,"Diary of a Shinjuku Thief (Shinjuku dorobo nikki)",1999,"https://www.youtube.com/embed/PdL8kn_G5EQ","https://encrypted-tbn0.gstatic.com/images?q=tbn:ANd9GcTpzv6ZkKQ_5fFlx242_ZFGnV3MuzyUBrlVMhbcTFBKJGCr7XxS",45,5.1,8301,1545,6756,"Proin eu mi. Nulla ac enim. In tempor, turpis nec euismod scelerisque, quam turpis adipiscing lorem, vitae mattis nibh ligula nec sem.",50,8838,26,4.1,7146,2352,4794
874,"Bill Cosby, Himself",1997,"https://www.youtube.com/embed/eqDHqOcXjRQ","https://encrypted-tbn0.gstatic.com/images?q=tbn:ANd9GcQN3_I47i-MkaTBmK9e2PzNkhGoJsWeB5U_dn5cat3hDSHLCPjU",31,3.6,7900,573,7327,"Vestibulum quam sapien, varius ut, blandit non, interdum in, ante. Vestibulum ante ipsum primis in faucibus orci luctus et ultrices posuere cubilia Curae; Duis faucibus accumsan odio. Curabitur convallis.",40,458,96,8.4,9822,4860,4962
875,"Clifford",1989,"https://www.youtube.com/embed/9gWsyEkKO1A","https://encrypted-tbn0.gstatic.com/images?q=tbn:ANd9GcRyMl7AW_r-FXiuqUSSUA5Mww484NZ8QAd_-vEbcfX2bB8j-uCn1g",19,1.2,2034,5284,-3250,"Pellentesque at nulla. Suspendisse potenti. Cras in purus eu magna vulputate luctus.",40,8838,64,6.8,8382,573,7809
876,"The Wrong Move",1989,"https://www.youtube.com/embed/DIOW-kR_ams","https://encrypted-tbn0.gstatic.com/images?q=tbn:ANd9GcRTcG2_JqWMZJOf6uyZm7vI1GQGSsjWkKgxCokuA40pthaOj9LOFQ",22,2,4108,1590,2518,"Nam ultrices, libero non mattis pulvinar, nulla pede ullamcorper augue, a suscipit nulla elit ac nulla. Sed vel enim sit amet nunc viverra dapibus. Nulla suscipit ligula in lacus.",26,1631,23,1.8,7762,7659,103
877,"The Land Before Time XII: The Great Day of the Flyers",1994,"https://www.youtube.com/embed/ka3J1sUhQ4M","https://encrypted-tbn0.gstatic.com/images?q=tbn:ANd9GcTrBuPeRIXbqvHjWMwFg1aZvVkw71rsNVla5A067w7kiY-DPB7N",18,4.9,198,8964,-8766,"Cras non velit nec nisi vulputate nonummy. Maecenas tincidunt lacus at velit. Vivamus vel nulla eget eros elementum pellentesque.",66,6777,23,8.9,6006,73,5933
878,"The Long Voyage Home",1997,"https://www.youtube.com/embed/uaTAhjdaEuY","https://encrypted-tbn0.gstatic.com/images?q=tbn:ANd9GcRWaaeSy6yTdILVOdHiDa9DWFAM4DhQ1JlJvUBR4vWbVoeZznD-",26,4.2,2323,2311,12,"Suspendisse potenti. In eleifend quam a odio. In hac habitasse platea dictumst.",58,8039,62,1.2,4286,879,3407
879,"Block-Heads",1999,"https://www.youtube.com/embed/LO9I2fpyUyg","https://encrypted-tbn0.gstatic.com/images?q=tbn:ANd9GcRxLYJSuzc9AAuuJ3R1HulbKM_T8_whdwPZQj7VyYonHOME6fYq",6,5.1,3019,4196,-1177,"Curabitur in libero ut massa volutpat convallis. Morbi odio odio, elementum eu, interdum eu, tincidunt in, leo. Maecenas pulvinar lobortis est.",70,3074,65,2.4,698,3563,-2865
880,"Vicky Donor",2005,"https://www.youtube.com/embed/fnLjm_yL7vE","https://encrypted-tbn0.gstatic.com/images?q=tbn:ANd9GcRboE_Oz4pmq_fbkSzc09GrZ6-FxQU9Zh64Y6b3LNLomLOlE4VEzQ",38,2.4,3605,4860,-1255,"Maecenas tristique, est et tempus semper, est quam pharetra magna, ac consequat metus sapien ut nunc. Vestibulum ante ipsum primis in faucibus orci luctus et ultrices posuere cubilia Curae; Mauris viverra diam vitae quam. Suspendisse potenti.",62,1277,37,9.1,9899,923,8976
881,"Azumi 2: Death or Love",1997,"https://www.youtube.com/embed/iW3t_wUDG5U","https://encrypted-tbn0.gstatic.com/images?q=tbn:ANd9GcT8fsnqcp8Y3Y2dxkM4H8TJyS7bRYttijiNFZ-mruoqpzO29uM7",31,8.5,9389,1496,7893,"Morbi porttitor lorem id ligula. Suspendisse ornare consequat lectus. In est risus, auctor sed, tristique in, tempus sit amet, sem.",88,2629,45,8.8,2016,8004,-5988
882,"The Poseidon Adventure",1992,"https://www.youtube.com/embed/B12REtkl2KY","https://encrypted-tbn0.gstatic.com/images?q=tbn:ANd9GcQvfJ-vLQ5TK13ND8sY6H-r6cm_4f3SnW_WAWn2vuX-nGh6F8JquQ",26,6.3,7162,3563,3599,"Proin eu mi. Nulla ac enim. In tempor, turpis nec euismod scelerisque, quam turpis adipiscing lorem, vitae mattis nibh ligula nec sem.",48,8056,10,4.1,6386,156,6230
883,"Dr. Jekyll and Ms. Hyde",2002,"https://www.youtube.com/embed/giIs-AEAX6Y","https://encrypted-tbn0.gstatic.com/images?q=tbn:ANd9GcQX7g7WDTuGnT2syPcShrXK1gFJn4uMaACeAnWvesheIZXX58K1",80,7.7,9389,156,9233,"Lorem ipsum dolor sit amet, consectetuer adipiscing elit. Proin risus. Praesent lectus.",48,4185,35,3.2,9822,2999,6823
884,"Iceberg, L'",2011,"https://www.youtube.com/embed/dfUJm6XgD7g","https://encrypted-tbn0.gstatic.com/images?q=tbn:ANd9GcSigGMCEOHmqUMTkf9z3wcQTZlj2VM5cRueb-YgaX9_Hkej2qI5mQ",31,8.1,3411,156,3255,"Curabitur in libero ut massa volutpat convallis. Morbi odio odio, elementum eu, interdum eu, tincidunt in, leo. Maecenas pulvinar lobortis est.",22,3119,24,5.1,6275,3563,2712
885,"Elvis Meets Nixon",2011,"https://www.youtube.com/embed/oNTzFnMXT3E","https://encrypted-tbn0.gstatic.com/images?q=tbn:ANd9GcQX7g7WDTuGnT2syPcShrXK1gFJn4uMaACeAnWvesheIZXX58K1",57,5.1,7762,1545,6217,"Praesent blandit. Nam nulla. Integer pede justo, lacinia eget, tincidunt eget, tempus vel, pede.",58,2822,70,3.2,2733,1733,1000
886,"Aloft",1997,"https://www.youtube.com/embed/1roy4o4tqQM","https://encrypted-tbn0.gstatic.com/images?q=tbn:ANd9GcQ06LkOABmCBkCQO4wr6V0tHNUOyUYNR-YLaEHAblZo1ZqlooBmOg",81,2,3530,1504,2026,"Suspendisse potenti. In eleifend quam a odio. In hac habitasse platea dictumst.",50,9885,41,8.1,9090,156,8934
887,"Fair Game",2011,"https://www.youtube.com/embed/COTt1zvBUJk","https://encrypted-tbn0.gstatic.com/images?q=tbn:ANd9GcRfaybDSA3hF-btWMAObj0lbtp7UbFPvvC41dZ9EEL1BMISwxF6",28,6.7,3417,4,3413,"Aliquam quis turpis eget elit sodales scelerisque. Mauris sit amet eros. Suspendisse accumsan tortor quis turpis.",80,2789,64,5.1,7383,6366,1017
888,"Holy Flame of the Martial World (Wu lin sheng huo jin)",1987,"https://www.youtube.com/embed/h-k0-Z9b4Cw","https://encrypted-tbn0.gstatic.com/images?q=tbn:ANd9GcT5qYZ7WL1XpLSuZms35fvGdxwAwN8ZoDje7zRyyFHfFSsWWAHelQ",66,5.7,9696,831,8865,"Lorem ipsum dolor sit amet, consectetuer adipiscing elit. Proin risus. Praesent lectus.",88,7702,19,1.7,8429,2001,6428
889,"Transylvania",2006,"https://www.youtube.com/embed/fPq4zW9QZSg","https://encrypted-tbn0.gstatic.com/images?q=tbn:ANd9GcQ4tG7BC0SE2SNUji4NBAmTKKl13L-IuMZpkiEbQm0YeWk9Z1SQUg",95,1.8,7576,6494,1082,"In hac habitasse platea dictumst. Etiam faucibus cursus urna. Ut tellus.",82,5615,77,6,7383,2443,4940
890,"Barabbas",2011,"https://www.youtube.com/embed/7C2Nad0aMPg","https://encrypted-tbn0.gstatic.com/images?q=tbn:ANd9GcQN3_I47i-MkaTBmK9e2PzNkhGoJsWeB5U_dn5cat3hDSHLCPjU",31,1.2,4602,1865,2737,"Phasellus sit amet erat. Nulla tempus. Vivamus in felis eu sapien cursus vestibulum.",28,4897,66,2.1,9090,5,9085
891,"Thunder Bay",1996,"https://www.youtube.com/embed/Sw_5YPAf7Zs","https://encrypted-tbn0.gstatic.com/images?q=tbn:ANd9GcSabPrm9QL3aakFmkc9kWlHSQ9uzP10Yf493F57vDv3FicybY8YIg",70,9.5,8382,6892,1490,"Nam ultrices, libero non mattis pulvinar, nulla pede ullamcorper augue, a suscipit nulla elit ac nulla. Sed vel enim sit amet nunc viverra dapibus. Nulla suscipit ligula in lacus.",64,6673,43,2.4,5160,1560,3600
892,"Little Nikita",1992,"https://www.youtube.com/embed/COTt1zvBUJk","https://encrypted-tbn0.gstatic.com/images?q=tbn:ANd9GcTt-58zOD-K4oKQ0AbvYduMdi-NxFRYLjx9Maf9ECQJMZkvfanqUw",64,3.1,7900,4196,3704,"Suspendisse potenti. In eleifend quam a odio. In hac habitasse platea dictumst.",26,9178,25,3.4,9822,3251,6571
893,"Prince Valiant",1989,"https://www.youtube.com/embed/PdL8kn_G5EQ","https://encrypted-tbn0.gstatic.com/images?q=tbn:ANd9GcQtbFBdNfjGVCo1GPJC_9PUkUc7wRIwwh0PMwS76SEP_QTtAyat",26,9.5,7715,3412,4303,"Proin eu mi. Nulla ac enim. In tempor, turpis nec euismod scelerisque, quam turpis adipiscing lorem, vitae mattis nibh ligula nec sem.",70,8546,31,1.2,3417,4124,-707
894,"Poolboy: Drowning Out the Fury",1989,"https://www.youtube.com/embed/tkSuLa3o_5A","https://i.pinimg.com/236x/5f/f6/69/5ff6693c3694f55e8ed9738084c4c6b1--d-design-design-concepts.jpg",98,5.7,8446,1504,6942,"Sed ante. Vivamus tortor. Duis mattis egestas metus.",26,1589,48,8.3,8377,1575,6802
895,"In the Line of Duty: The F.B.I. Murders",2005,"https://www.youtube.com/embed/hvDwA_EDcOQ","https://encrypted-tbn0.gstatic.com/images?q=tbn:ANd9GcTVx6QbLHPUKkVSj1TkaOANhnRfjtIXHhKnHSaIR2y3RkCgry-X",2,7.2,5541,537,5004,"In congue. Etiam justo. Etiam pretium iaculis justo.",80,2840,56,3.4,1191,5228,-4037
896,"The Stars Fell on Henrietta",1994,"https://www.youtube.com/embed/EKGATzNnr8c","https://encrypted-tbn0.gstatic.com/images?q=tbn:ANd9GcSkP7ePajJciblvooQK7qTSV2J0ZdjBzPxrRi7NvBHdmOLYWeT4",26,7.2,8226,2711,5515,"Donec diam neque, vestibulum eget, vulputate ut, ultrices vel, augue. Vestibulum ante ipsum primis in faucibus orci luctus et ultrices posuere cubilia Curae; Donec pharetra, magna vestibulum aliquet ultrices, erat tortor sollicitudin mi, sit amet lobortis sapien sapien non mi. Integer ac neque.",22,7121,4,7.7,5943,3444,2499
897,"Sgt. Bilko",1997,"https://www.youtube.com/embed/BQcvHEkGaEA","https://encrypted-tbn0.gstatic.com/images?q=tbn:ANd9GcT11kibbY7ZQKvhvKatIRRKfv-n-n77Ve-QuVdMOoMg-fol_k9j",42,5.7,8410,218,8192,"Fusce consequat. Nulla nisl. Nunc nisl.",98,9885,66,2.1,9994,6494,3500
898,"The Browning Version",2006,"https://www.youtube.com/embed/iaM3y7uDL90","https://encrypted-tbn0.gstatic.com/images?q=tbn:ANd9GcTppyYABMyqegOc4I6b3NS0iUaX0R6Cy1-PlahMrPPUzzqPNux9Gg",82,6.8,3923,1214,2709,"Quisque porta volutpat erat. Quisque erat eros, viverra eget, congue eget, semper rutrum, nulla. Nunc purus.",40,1649,4,5.1,284,8004,-7720
899,"When Time Ran Out...",1997,"https://www.youtube.com/embed/DIOW-kR_ams","https://encrypted-tbn0.gstatic.com/images?q=tbn:ANd9GcQLt0-lz7NK5w-_elA1XCxyK77lQX2-JBVeEkkOx2aJ8RjYYqE4Vw",88,5.1,1795,5515,-3720,"Curabitur in libero ut massa volutpat convallis. Morbi odio odio, elementum eu, interdum eu, tincidunt in, leo. Maecenas pulvinar lobortis est.",42,8065,81,5.8,2409,2617,-208
900,"Joe Kidd",1997,"https://www.youtube.com/embed/8W6yYBAUxv4","https://encrypted-tbn0.gstatic.com/images?q=tbn:ANd9GcRfaybDSA3hF-btWMAObj0lbtp7UbFPvvC41dZ9EEL1BMISwxF6",28,7,5146,6427,-1281,"Quisque id justo sit amet sapien dignissim vestibulum. Vestibulum ante ipsum primis in faucibus orci luctus et ultrices posuere cubilia Curae; Nulla dapibus dolor vel est. Donec odio justo, sollicitudin ut, suscipit a, feugiat et, eros.",48,1836,10,3.4,6469,3421,3048
901,"Thoroughly Modern Millie",2011,"https://www.youtube.com/embed/ka3J1sUhQ4M","https://encrypted-tbn0.gstatic.com/images?q=tbn:ANd9GcSxYkdQhkFdrUcKH8fJB2yXGC_mRCGuYTVOQUJTDJY0t9GQ7I2_",94,2,2779,2489,290,"Sed ante. Vivamus tortor. Duis mattis egestas metus.",96,2629,61,1.4,9090,1214,7876
902,"Coming Down the Mountain",1992,"https://www.youtube.com/embed/1roy4o4tqQM","https://encrypted-tbn0.gstatic.com/images?q=tbn:ANd9GcR_EXv1N1pkhMX0O3KAJXlTgC0_KL4WpSRDxUzH2CO9RPypuvxDAw",42,7.2,7162,2596,4566,"Quisque porta volutpat erat. Quisque erat eros, viverra eget, congue eget, semper rutrum, nulla. Nunc purus.",54,2629,59,5.1,2409,213,2196
903,"Azumi 2: Death or Love",1997,"https://www.youtube.com/embed/hvDwA_EDcOQ","https://encrypted-tbn0.gstatic.com/images?q=tbn:ANd9GcTiS27rf1ltLwxOAbTBhYvqJuvJG8ctIALtoknQh7MHlvV3r0UO",56,2.9,8226,218,8008,"Quisque porta volutpat erat. Quisque erat eros, viverra eget, congue eget, semper rutrum, nulla. Nunc purus.",52,5941,78,4.6,2733,562,2171
904,"Beyond Therapy",2011,"https://www.youtube.com/embed/Xwzwmc2AZYg","https://encrypted-tbn0.gstatic.com/images?q=tbn:ANd9GcQhhglaTqXYejQ2b9TYl15F3E4pAgR1pWjyYyUTJgkHGuKsiWyHrw",77,5.7,6801,2999,3802,"Integer ac leo. Pellentesque ultrices mattis odio. Donec vitae nisi.",64,510,81,5.7,9389,3563,5826
905,"Block-Heads",1999,"https://www.youtube.com/embed/DIOW-kR_ams","https://encrypted-tbn0.gstatic.com/images?q=tbn:ANd9GcRXW_MDHretVBvFBnfeqtLtE86uQkY-GTeOH_gP8OZY1Znu6a86qg",4,5.1,3530,3563,-33,"Cras non velit nec nisi vulputate nonummy. Maecenas tincidunt lacus at velit. Vivamus vel nulla eget eros elementum pellentesque.",96,1589,20,7,8388,2606,5782
906,"Quand je serai petit",2001,"https://www.youtube.com/embed/IU3xV9ZRYlk","https://encrypted-tbn0.gstatic.com/images?q=tbn:ANd9GcQhhglaTqXYejQ2b9TYl15F3E4pAgR1pWjyYyUTJgkHGuKsiWyHrw",77,6.7,7162,3607,3555,"Aenean lectus. Pellentesque eget nunc. Donec quis orci eget orci vehicula condimentum.",96,6113,84,7,6175,3881,2294
907,"Harry Potter and the Order of the Phoenix",2010,"https://www.youtube.com/embed/kWuwuQ0X9OA","https://encrypted-tbn0.gstatic.com/images?q=tbn:ANd9GcSigGMCEOHmqUMTkf9z3wcQTZlj2VM5cRueb-YgaX9_Hkej2qI5mQ",42,2.8,3530,3251,279,"Phasellus sit amet erat. Nulla tempus. Vivamus in felis eu sapien cursus vestibulum.",82,9683,68,2.8,6275,218,6057
908,"Rabid Grannies (Mémés cannibales, Les)",2011,"https://www.youtube.com/embed/hvDwA_EDcOQ","https://encrypted-tbn0.gstatic.com/images?q=tbn:ANd9GcQoGIgMrMpVA2TiWG8g9ENb7x-ZrciYB-gqzjyCnG-C2EgT8ePfkA",40,4.4,7715,3539,4176,"Cras mi pede, malesuada in, imperdiet et, commodo vulputate, justo. In blandit ultrices enim. Lorem ipsum dolor sit amet, consectetuer adipiscing elit.",82,7690,17,7.2,698,2777,-2079
909,"Level Five",1997,"https://www.youtube.com/embed/1ywA8TtwJ50","https://encrypted-tbn0.gstatic.com/images?q=tbn:ANd9GcToWUNrpDN1sKiQrTBrAPVZaaHkjYWkdwsMh5Igburh2w20IPRs",60,8.5,698,73,625,"Sed sagittis. Nam congue, risus semper porta volutpat, quam pede lobortis ligula, sit amet eleifend pede libero quis orci. Nullam molestie nibh in lectus.",40,510,22,6.8,12,4125,-4113
910,"Babylon 5: In the Beginning",2012,"https://www.youtube.com/embed/KbZ3TVEkuDY","https://encrypted-tbn0.gstatic.com/images?q=tbn:ANd9GcQ06LkOABmCBkCQO4wr6V0tHNUOyUYNR-YLaEHAblZo1ZqlooBmOg",4,4.8,3605,831,2774,"Curabitur in libero ut massa volutpat convallis. Morbi odio odio, elementum eu, interdum eu, tincidunt in, leo. Maecenas pulvinar lobortis est.",96,2682,42,2.1,9899,1560,8339
911,"Little Nikita",2011,"https://www.youtube.com/embed/MPWMBITCudM","https://encrypted-tbn0.gstatic.com/images?q=tbn:ANd9GcTt-58zOD-K4oKQ0AbvYduMdi-NxFRYLjx9Maf9ECQJMZkvfanqUw",34,1.2,2481,6427,-3946,"Phasellus sit amet erat. Nulla tempus. Vivamus in felis eu sapien cursus vestibulum.",68,9382,28,5.7,6734,5515,1219
912,"Aloft",1999,"https://www.youtube.com/embed/OWwVD1xdAX4","https://encrypted-tbn0.gstatic.com/images?q=tbn:ANd9GcQInYhbERWHKRlaq1eJAqZqaGQ9zndtpCyGofdPFToPGHuZUGCS",13,2,3530,6892,-3362,"In sagittis dui vel nisl. Duis ac nibh. Fusce lacus purus, aliquet at, feugiat non, pretium quis, lectus.",70,1620,49,9.5,1360,2443,-1083
913,"The Pit, the Pendulum and Hope",1998,"https://www.youtube.com/embed/Rc3e0m6SpXo","https://encrypted-tbn0.gstatic.com/images?q=tbn:ANd9GcTTLFfQrJmhvXjL4d_udm6Z89QYglVi4hTEmbaDRdDoqHQsaQVg",66,9.6,7146,4860,2286,"Lorem ipsum dolor sit amet, consectetuer adipiscing elit. Proin risus. Praesent lectus.",62,93,55,3.4,3458,537,2921
914,"Dorado, El",2010,"https://www.youtube.com/embed/MpJEOpsVWtA","https://encrypted-tbn0.gstatic.com/images?q=tbn:ANd9GcTlHaTq59e08Zugqn9ZX71XQYUOtuUGEQ9Mkl_HR1NmuSBceL7O",38,2.4,8454,879,7575,"Integer tincidunt ante vel ipsum. Praesent blandit lacinia erat. Vestibulum sed magna at nunc commodo placerat.",38,281,2,1.8,1360,5471,-4111
915,"In the Line of Duty: The F.B.I. Murders",2006,"https://www.youtube.com/embed/RyYFAqJFYdE","https://encrypted-tbn0.gstatic.com/images?q=tbn:ANd9GcR6OdK3cVIVUn07PmO7zFQb1JyTfdi6L4FwxFWOD9dfwTwN4hEt",45,3.6,12,1592,-1580,"Donec diam neque, vestibulum eget, vulputate ut, ultrices vel, augue. Vestibulum ante ipsum primis in faucibus orci luctus et ultrices posuere cubilia Curae; Donec pharetra, magna vestibulum aliquet ultrices, erat tortor sollicitudin mi, sit amet lobortis sapien sapien non mi. Integer ac neque.",34,510,57,3.2,8410,1504,6906
916,"King Kong",1995,"https://www.youtube.com/embed/4AEkzL2SvmI","https://encrypted-tbn0.gstatic.com/images?q=tbn:ANd9GcRZ2qgbwUkZMB6Z3KUBla8OIzYNOBzMaNpoAeNofRYZj8V27vwD",66,3.6,5541,1898,3643,"Curabitur in libero ut massa volutpat convallis. Morbi odio odio, elementum eu, interdum eu, tincidunt in, leo. Maecenas pulvinar lobortis est.",64,8013,98,5.9,2016,218,1798
917,"Fair Game",1996,"https://www.youtube.com/embed/2FbDY0MeJf8","https://encrypted-tbn0.gstatic.com/images?q=tbn:ANd9GcQ06LkOABmCBkCQO4wr6V0tHNUOyUYNR-YLaEHAblZo1ZqlooBmOg",94,1.7,6072,2443,3629,"Fusce consequat. Nulla nisl. Nunc nisl.",44,7481,89,7.2,7146,6554,592
918,"Miami Vice",1999,"https://www.youtube.com/embed/oNTzFnMXT3E","https://encrypted-tbn0.gstatic.com/images?q=tbn:ANd9GcSJJAS-aY5yM_o538SFwYJKMI1ICZvCAEdnVZX59tINRulVx7aBpA",48,6.8,7683,176,7507,"Cum sociis natoque penatibus et magnis dis parturient montes, nascetur ridiculus mus. Vivamus vestibulum sagittis sapien. Cum sociis natoque penatibus et magnis dis parturient montes, nascetur ridiculus mus.",100,1948,43,3.4,5542,3428,2114
919,"Protector (Protektor)",2000,"https://www.youtube.com/embed/hvDwA_EDcOQ","https://encrypted-tbn0.gstatic.com/images?q=tbn:ANd9GcQYYT2HR82Tm6jDN6B_0-JbBC3HMcVQoxrwz0iiWHkiPx0sXczovQ",34,4.6,3417,537,2880,"Proin eu mi. Nulla ac enim. In tempor, turpis nec euismod scelerisque, quam turpis adipiscing lorem, vitae mattis nibh ligula nec sem.",48,3444,65,3.2,7162,1025,6137
920,"Little Boy Blue",2010,"https://www.youtube.com/embed/3_bUymlkSuA","https://encrypted-tbn0.gstatic.com/images?q=tbn:ANd9GcS0uoN_00qCw12_q1GgGAdcbA-6sp6JzFguYZMxLObI8Ydh9OBk",70,4.3,9090,3421,5669,"Phasellus in felis. Donec semper sapien a libero. Nam dui.",96,7069,11,3.2,6072,2596,3476
921,"The Big Trail",2008,"https://www.youtube.com/embed/78ozCL4sQoI","https://encrypted-tbn0.gstatic.com/images?q=tbn:ANd9GcSZ6r6rDjMvQsp22jqT0ZPe_z-oKhAWQcjwgB5egzck4lqzLHYHCg",98,2.9,9994,3074,6920,"Donec diam neque, vestibulum eget, vulputate ut, ultrices vel, augue. Vestibulum ante ipsum primis in faucibus orci luctus et ultrices posuere cubilia Curae; Donec pharetra, magna vestibulum aliquet ultrices, erat tortor sollicitudin mi, sit amet lobortis sapien sapien non mi. Integer ac neque.",64,7498,95,6.8,8301,156,8145
922,"Barabbas",1986,"https://www.youtube.com/embed/jEnIfGQ_UuQ","https://encrypted-tbn0.gstatic.com/images?q=tbn:ANd9GcSJJAS-aY5yM_o538SFwYJKMI1ICZvCAEdnVZX59tINRulVx7aBpA",17,4.1,1191,5471,-4280,"Donec diam neque, vestibulum eget, vulputate ut, ultrices vel, augue. Vestibulum ante ipsum primis in faucibus orci luctus et ultrices posuere cubilia Curae; Donec pharetra, magna vestibulum aliquet ultrices, erat tortor sollicitudin mi, sit amet lobortis sapien sapien non mi. Integer ac neque.",32,9164,2,9.5,2883,831,2052
923,"Payday",2000,"https://www.youtube.com/embed/mAX1oGLvMAA","https://encrypted-tbn0.gstatic.com/images?q=tbn:ANd9GcRmeUcg7O8EkPtcOaGTwx1hvLuj5TbCPLmfq_zT0IhPpcbOWbBUDA",33,5.1,1191,1496,-305,"Curabitur in libero ut massa volutpat convallis. Morbi odio odio, elementum eu, interdum eu, tincidunt in, leo. Maecenas pulvinar lobortis est.",22,2476,41,2,692,1061,-369
924,"Azumi 2: Death or Love",1999,"https://www.youtube.com/embed/6W0KFTj50zI","https://encrypted-tbn0.gstatic.com/images?q=tbn:ANd9GcQN3_I47i-MkaTBmK9e2PzNkhGoJsWeB5U_dn5cat3hDSHLCPjU",3,9.3,5542,537,5005,"Cras mi pede, malesuada in, imperdiet et, commodo vulputate, justo. In blandit ultrices enim. Lorem ipsum dolor sit amet, consectetuer adipiscing elit.",66,4869,70,5.8,8437,5471,2966
925,"The Tic Code",2011,"https://www.youtube.com/embed/iOMxsy8S7hk","https://encrypted-tbn0.gstatic.com/images?q=tbn:ANd9GcR_EXv1N1pkhMX0O3KAJXlTgC0_KL4WpSRDxUzH2CO9RPypuvxDAw",4,9.6,2269,2777,-508,"Donec diam neque, vestibulum eget, vulputate ut, ultrices vel, augue. Vestibulum ante ipsum primis in faucibus orci luctus et ultrices posuere cubilia Curae; Donec pharetra, magna vestibulum aliquet ultrices, erat tortor sollicitudin mi, sit amet lobortis sapien sapien non mi. Integer ac neque.",26,6868,24,8.8,4286,8629,-4343
926,"Lust for Gold",1985,"https://www.youtube.com/embed/eAIjuMHKEiA","https://encrypted-tbn0.gstatic.com/images?q=tbn:ANd9GcTlHaTq59e08Zugqn9ZX71XQYUOtuUGEQ9Mkl_HR1NmuSBceL7O",57,8.3,8226,6494,1732,"Proin eu mi. Nulla ac enim. In tempor, turpis nec euismod scelerisque, quam turpis adipiscing lorem, vitae mattis nibh ligula nec sem.",30,8135,34,4.6,1795,305,1490
927,"Joe Kidd",1989,"https://www.youtube.com/embed/Xwzwmc2AZYg","https://encrypted-tbn0.gstatic.com/images?q=tbn:ANd9GcQ1aky5NsvfU2oObNVwH5j9ZHJNNcxRkRhHEYTh8yhtqNLPmxk0lA",31,5.1,5704,2999,2705,"Cras mi pede, malesuada in, imperdiet et, commodo vulputate, justo. In blandit ultrices enim. Lorem ipsum dolor sit amet, consectetuer adipiscing elit.",38,8838,69,1.1,7383,1496,5887
928,"Another Woman",2003,"https://www.youtube.com/embed/Bn9iowpSWRs","https://encrypted-tbn0.gstatic.com/images?q=tbn:ANd9GcQInYhbERWHKRlaq1eJAqZqaGQ9zndtpCyGofdPFToPGHuZUGCS",69,4.8,5541,8004,-2463,"Fusce consequat. Nulla nisl. Nunc nisl.",48,694,98,3.4,6072,9584,-3512
929,"In the Line of Duty: The F.B.I. Murders",2003,"https://www.youtube.com/embed/REXXOGV1IIE","https://encrypted-tbn0.gstatic.com/images?q=tbn:ANd9GcSYy4S-T_nbr708KkpYcV-RgmyX_MPtCXzFVr44X7S9CAQsyQAE3Q",61,6.9,3624,627,2997,"Praesent blandit. Nam nulla. Integer pede justo, lacinia eget, tincidunt eget, tempus vel, pede.",76,93,81,1.2,7383,7659,-276
930,"The Sword of Doom",2008,"https://www.youtube.com/embed/giIs-AEAX6Y","https://encrypted-tbn0.gstatic.com/images?q=tbn:ANd9GcQvfJ-vLQ5TK13ND8sY6H-r6cm_4f3SnW_WAWn2vuX-nGh6F8JquQ",26,4.7,3458,5471,-2013,"Sed sagittis. Nam congue, risus semper porta volutpat, quam pede lobortis ligula, sit amet eleifend pede libero quis orci. Nullam molestie nibh in lectus.",40,1649,34,1.8,2269,2606,-337
931,"Jin Roh: The Wolf Brigade (Jin-Rô)",1996,"https://www.youtube.com/embed/ee12SvnnrSw","https://encrypted-tbn0.gstatic.com/images?q=tbn:ANd9GcQLt0-lz7NK5w-_elA1XCxyK77lQX2-JBVeEkkOx2aJ8RjYYqE4Vw",26,1.8,9090,1374,7716,"Curabitur in libero ut massa volutpat convallis. Morbi odio odio, elementum eu, interdum eu, tincidunt in, leo. Maecenas pulvinar lobortis est.",38,607,25,6.1,8429,879,7550
932,"Escaflowne: The Movie (Escaflowne)",2006,"https://www.youtube.com/embed/8oTXc5t35Ro","https://encrypted-tbn0.gstatic.com/images?q=tbn:ANd9GcQKE0-ggtSuRrbc-0BlaVgTBu4zGwn22cMB8tEdwr9uHJJ9jXGs",25,2.4,9141,1983,7158,"Cum sociis natoque penatibus et magnis dis parturient montes, nascetur ridiculus mus. Vivamus vestibulum sagittis sapien. Cum sociis natoque penatibus et magnis dis parturient montes, nascetur ridiculus mus.",48,3444,6,9.6,6869,2777,4092
933,"King Kong",1985,"https://www.youtube.com/embed/MpJEOpsVWtA","https://encrypted-tbn0.gstatic.com/images?q=tbn:ANd9GcT8fsnqcp8Y3Y2dxkM4H8TJyS7bRYttijiNFZ-mruoqpzO29uM7",28,2.4,2034,1898,136,"Lorem ipsum dolor sit amet, consectetuer adipiscing elit. Proin risus. Praesent lectus.",44,4185,57,5.1,2323,2311,12
934,"Gorko!",1999,"https://www.youtube.com/embed/9gWsyEkKO1A","https://i.pinimg.com/736x/37/a0/99/37a099570abb65e478268af396315658--brochure-design-colour-combinations.jpg",34,7.8,2409,2777,-368,"Morbi non lectus. Aliquam sit amet diam in magna bibendum imperdiet. Nullam orci pede, venenatis non, sodales sed, tincidunt eu, felis.",56,7592,56,3.6,698,1575,-877
935,"Fido",2009,"https://www.youtube.com/embed/qqlEGYo0xCA","https://encrypted-tbn0.gstatic.com/images?q=tbn:ANd9GcRmeUcg7O8EkPtcOaGTwx1hvLuj5TbCPLmfq_zT0IhPpcbOWbBUDA",20,1.1,6734,7462,-728,"Quisque porta volutpat erat. Quisque erat eros, viverra eget, congue eget, semper rutrum, nulla. Nunc purus.",66,6593,48,1.7,6755,3444,3311
936,"The Stars Fell on Henrietta",1999,"https://www.youtube.com/embed/oNTzFnMXT3E","https://encrypted-tbn0.gstatic.com/images?q=tbn:ANd9GcRXW_MDHretVBvFBnfeqtLtE86uQkY-GTeOH_gP8OZY1Znu6a86qg",45,1.8,4602,2777,1825,"In hac habitasse platea dictumst. Etiam faucibus cursus urna. Ut tellus.",58,9382,18,1.7,5704,6427,-723
937,"Sgt. Bilko",2005,"https://www.youtube.com/embed/1ywA8TtwJ50","https://encrypted-tbn0.gstatic.com/images?q=tbn:ANd9GcTjDxlkO4SurlCq11A009Vm2yOW0XT4x5GHflg-pkVrTiqWURnydg",59,7,8446,1822,6624,"Proin leo odio, porttitor id, consequat in, consequat ut, nulla. Sed accumsan felis. Ut at dolor quis odio consequat varius.",56,5258,55,9,3890,2198,1692
938,"Confidence",1997,"https://www.youtube.com/embed/VccwBGgyzP4","https://encrypted-tbn0.gstatic.com/images?q=tbn:ANd9GcSsoy4iP--KOCJ5pPhAcbfrQSvWLPYPI3I557hNf2Vfb6OrfrOczg",26,8.8,3417,3607,-190,"Quisque porta volutpat erat. Quisque erat eros, viverra eget, congue eget, semper rutrum, nulla. Nunc purus.",50,9805,26,5.1,5943,3313,2630
939,"The Stars Fell on Henrietta",2003,"https://www.youtube.com/embed/MaI-4NepPfU","https://i.pinimg.com/originals/c9/ba/74/c9ba7451301a9003752d2f61b5036730.jpg",13,6.7,698,898,-200,"Proin eu mi. Nulla ac enim. In tempor, turpis nec euismod scelerisque, quam turpis adipiscing lorem, vitae mattis nibh ligula nec sem.",68,1631,64,9.3,7256,2777,4479
940,"The Pit, the Pendulum and Hope",2004,"https://www.youtube.com/embed/MPWMBITCudM","http://pictify.saatchigallery.com/files/works/chagall-vitraux-pour-jerusalem-poster-chagall-la-tribu-de-1363528645.jpg",28,2.4,3417,263,3154,"Quisque porta volutpat erat. Quisque erat eros, viverra eget, congue eget, semper rutrum, nulla. Nunc purus.",22,1948,80,6.9,8226,5515,2711
941,"Dragon Ball Z the Movie: The World's Strongest (a.k.a. Dragon Ball Z: The Strongest Guy in The World) (Doragon bôru Z: Kono yo de ichiban tsuyoi yatsu)",2002,"https://www.youtube.com/embed/vuzplFd3YVY","https://encrypted-tbn0.gstatic.com/images?q=tbn:ANd9GcRUMZIkgEW4ZtYyXTgo6uGdYksy7dreOkd-zJRc1uGna-GAnU3SDQ",82,8.5,8382,5228,3154,"Pellentesque at nulla. Suspendisse potenti. Cras in purus eu magna vulputate luctus.",72,6777,80,4.1,6774,3607,3167
942,"Lust for Gold",2011,"https://www.youtube.com/embed/qSs5zsGoqs4","https://encrypted-tbn0.gstatic.com/images?q=tbn:ANd9GcTppyYABMyqegOc4I6b3NS0iUaX0R6Cy1-PlahMrPPUzzqPNux9Gg",70,6.9,6072,1898,4174,"Proin eu mi. Nulla ac enim. In tempor, turpis nec euismod scelerisque, quam turpis adipiscing lorem, vitae mattis nibh ligula nec sem.",66,2629,70,2,8301,3371,4930
943,"Lust for Gold",1999,"https://www.youtube.com/embed/B12REtkl2KY","https://encrypted-tbn0.gstatic.com/images?q=tbn:ANd9GcT3yd_NJLFNa8pH2NX8GufmbmYJmY751UxjTNcB2ALIMGhKfx94gQ",90,1.2,8454,6494,1960,"Praesent blandit. Nam nulla. Integer pede justo, lacinia eget, tincidunt eget, tempus vel, pede.",88,1379,17,3.4,8382,4124,4258
944,"The Story of Xinghua",2003,"https://www.youtube.com/embed/ee12SvnnrSw","https://encrypted-tbn0.gstatic.com/images?q=tbn:ANd9GcRXW_MDHretVBvFBnfeqtLtE86uQkY-GTeOH_gP8OZY1Znu6a86qg",64,4.7,7762,2489,5273,"Aenean lectus. Pellentesque eget nunc. Donec quis orci eget orci vehicula condimentum.",60,1882,6,8.9,8816,3428,5388
945,"Sky Fighters (Les Chevaliers Du Ciel)",1994,"https://www.youtube.com/embed/iM8kaNCrnX0","https://encrypted-tbn0.gstatic.com/images?q=tbn:ANd9GcTppyYABMyqegOc4I6b3NS0iUaX0R6Cy1-PlahMrPPUzzqPNux9Gg",56,8.1,6275,6427,-152,"Praesent blandit. Nam nulla. Integer pede justo, lacinia eget, tincidunt eget, tempus vel, pede.",50,9164,49,6.7,6734,2606,4128
946,"The Pit, the Pendulum and Hope",2001,"https://www.youtube.com/embed/MaI-4NepPfU","https://encrypted-tbn0.gstatic.com/images?q=tbn:ANd9GcTpzv6ZkKQ_5fFlx242_ZFGnV3MuzyUBrlVMhbcTFBKJGCr7XxS",60,8.1,9141,4196,4945,"Curabitur in libero ut massa volutpat convallis. Morbi odio odio, elementum eu, interdum eu, tincidunt in, leo. Maecenas pulvinar lobortis est.",28,3444,78,9,7146,2443,4703
947,"The Cell 2",1985,"https://www.youtube.com/embed/YVYzxm_RqMg","https://encrypted-tbn0.gstatic.com/images?q=tbn:ANd9GcQ--11hFR6GYIOagDhcOJiqKSIqKz7XB_wRhQklbSwf9d4k8lto",56,9.5,6072,627,5445,"Pellentesque at nulla. Suspendisse potenti. Cras in purus eu magna vulputate luctus.",64,2413,95,2.8,6801,2711,4090
948,"Babylon 5: In the Beginning",2001,"https://www.youtube.com/embed/THq6KlWgiqw","https://encrypted-tbn0.gstatic.com/images?q=tbn:ANd9GcTrBuPeRIXbqvHjWMwFg1aZvVkw71rsNVla5A067w7kiY-DPB7N",80,8.8,9141,2999,6142,"Morbi non lectus. Aliquam sit amet diam in magna bibendum imperdiet. Nullam orci pede, venenatis non, sodales sed, tincidunt eu, felis.",70,1277,42,1.8,3458,6885,-3427
949,"The Living Magoroku",2006,"https://www.youtube.com/embed/eAIjuMHKEiA","https://encrypted-tbn0.gstatic.com/images?q=tbn:ANd9GcQ1NxrNXukXKIzYZ8UbVazSnR-5741v5UDQPpMMVUvn_2I28fMZ",80,1,8454,5228,3226,"Proin interdum mauris non ligula pellentesque ultrices. Phasellus id sapien in sapien iaculis congue. Vivamus metus arcu, adipiscing molestie, hendrerit at, vulputate vitae, nisl.",48,6770,34,9.5,5498,285,5213
950,"The Browning Version",2009,"https://www.youtube.com/embed/8oTXc5t35Ro","https://encrypted-tbn0.gstatic.com/images?q=tbn:ANd9GcTlHaTq59e08Zugqn9ZX71XQYUOtuUGEQ9Mkl_HR1NmuSBceL7O",48,1.7,2779,3074,-295,"Praesent blandit. Nam nulla. Integer pede justo, lacinia eget, tincidunt eget, tempus vel, pede.",58,9178,55,7.7,2795,5228,-2433
951,"The Prisoner",2008,"https://www.youtube.com/embed/2BoyDp49C6Y","https://encrypted-tbn0.gstatic.com/images?q=tbn:ANd9GcQtbFBdNfjGVCo1GPJC_9PUkUc7wRIwwh0PMwS76SEP_QTtAyat",70,1.1,5542,1061,4481,"Sed ante. Vivamus tortor. Duis mattis egestas metus.",70,9178,70,4.9,7683,176,7507
952,"Dr. Jekyll and Ms. Hyde",2006,"https://www.youtube.com/embed/uaTAhjdaEuY","https://encrypted-tbn0.gstatic.com/images?q=tbn:ANd9GcS_NoH0Aw_5YFsBFwfBPn_O7YPHXumI5V3iQ2s7B-3zPU_7sSm1gA",57,2.4,9122,1865,7257,"Quisque porta volutpat erat. Quisque erat eros, viverra eget, congue eget, semper rutrum, nulla. Nunc purus.",58,8013,98,9.1,284,627,-343
953,"Bird of Paradise",2009,"https://www.youtube.com/embed/sZ8e_0i7UDk","https://encrypted-tbn0.gstatic.com/images?q=tbn:ANd9GcSC_qEbYtBeELogQVPTeiWNRbcOXlYKbMYmMPaG67T_yrWKEiTV",87,8.4,1191,2777,-1586,"Curabitur in libero ut massa volutpat convallis. Morbi odio odio, elementum eu, interdum eu, tincidunt in, leo. Maecenas pulvinar lobortis est.",88,6113,3,1.2,6275,2443,3832
954,"Alive",2000,"https://www.youtube.com/embed/3svtRyLq3b0","https://encrypted-tbn0.gstatic.com/images?q=tbn:ANd9GcSutU5UF40fwtxDcA61fL6VFTPKJYlaJOeUxSuI4qfpFQYO1KZ3",62,9,4108,923,3185,"Nam ultrices, libero non mattis pulvinar, nulla pede ullamcorper augue, a suscipit nulla elit ac nulla. Sed vel enim sit amet nunc viverra dapibus. Nulla suscipit ligula in lacus.",56,8056,34,5.1,9994,156,9838
955,"Jin Roh: The Wolf Brigade (Jin-Rô)",2011,"https://www.youtube.com/embed/LcepHRTWI18","https://encrypted-tbn0.gstatic.com/images?q=tbn:ANd9GcT11kibbY7ZQKvhvKatIRRKfv-n-n77Ve-QuVdMOoMg-fol_k9j",23,2.4,8816,2489,6327,"Morbi non lectus. Aliquam sit amet diam in magna bibendum imperdiet. Nullam orci pede, venenatis non, sodales sed, tincidunt eu, felis.",30,4185,30,5.1,2269,2198,71
956,"The Living Magoroku",2003,"https://www.youtube.com/embed/B12REtkl2KY","https://encrypted-tbn0.gstatic.com/images?q=tbn:ANd9GcR_EXv1N1pkhMX0O3KAJXlTgC0_KL4WpSRDxUzH2CO9RPypuvxDAw",43,8.4,7762,1374,6388,"Quisque id justo sit amet sapien dignissim vestibulum. Vestibulum ante ipsum primis in faucibus orci luctus et ultrices posuere cubilia Curae; Nulla dapibus dolor vel est. Donec odio justo, sollicitudin ut, suscipit a, feugiat et, eros.",50,5002,61,2.1,2323,3313,-990
957,"Wing and a Prayer",2005,"https://www.youtube.com/embed/oP-fRX_gB6o","https://encrypted-tbn0.gstatic.com/images?q=tbn:ANd9GcR203qZ3CqJHkReGO_urfLpOmRqqwbZ6g8ZOVV-2aZbySbWl_abdg",3,7.7,3890,2240,1650,"Nulla ut erat id mauris vulputate elementum. Nullam varius. Nulla facilisi.",58,4869,34,8.9,8446,1733,6713
958,"Lust for Gold",1985,"https://www.youtube.com/embed/Sw_5YPAf7Zs","https://encrypted-tbn0.gstatic.com/images?q=tbn:ANd9GcQ1NxrNXukXKIzYZ8UbVazSnR-5741v5UDQPpMMVUvn_2I28fMZ",75,9.1,3605,1983,1622,"Suspendisse potenti. In eleifend quam a odio. In hac habitasse platea dictumst.",44,6159,34,5.8,9141,1061,8080
959,"Clifford",2006,"https://www.youtube.com/embed/nMVDQZ34joY","https://encrypted-tbn0.gstatic.com/images?q=tbn:ANd9GcSRkE8RSex-89LA2Msfb1Vq6eH047lvDYppmp9IwK2zLgw2nbE-Uw",56,2.4,7146,6427,719,"Integer ac leo. Pellentesque ultrices mattis odio. Donec vitae nisi.",58,2153,7,2.9,5954,1865,4089
960,"The Paradine Case",2010,"https://www.youtube.com/embed/8W6yYBAUxv4","https://encrypted-tbn0.gstatic.com/images?q=tbn:ANd9GcQ1aky5NsvfU2oObNVwH5j9ZHJNNcxRkRhHEYTh8yhtqNLPmxk0lA",35,5.4,1795,1545,250,"Fusce consequat. Nulla nisl. Nunc nisl.",28,2822,49,1.8,284,3444,-3160
961,"The Gaucho",1992,"https://www.youtube.com/embed/VccwBGgyzP4","https://i.pinimg.com/236x/77/50/b3/7750b3ebe0787ae8e9beb7e2615e3b01.jpg",70,3.4,198,1575,-1377,"Sed sagittis. Nam congue, risus semper porta volutpat, quam pede lobortis ligula, sit amet eleifend pede libero quis orci. Nullam molestie nibh in lectus.",34,1948,89,1.2,12,1592,-1580
962,"The Paradine Case",1994,"https://www.youtube.com/embed/yuYoFVHkvIA","https://encrypted-tbn0.gstatic.com/images?q=tbn:ANd9GcSBKrAU7qHXZ_vqij5HmW3xvTgSZ9qA7lT4fxAsUEXHGvWHHXai",44,5.9,5529,1545,3984,"Pellentesque at nulla. Suspendisse potenti. Cras in purus eu magna vulputate luctus.",86,8546,36,6.9,8437,5228,3209
963,"All These Women (För att inte tala om alla dessa kvinnor)",2012,"https://www.youtube.com/embed/vuzplFd3YVY","https://encrypted-tbn0.gstatic.com/images?q=tbn:ANd9GcSsoy4iP--KOCJ5pPhAcbfrQSvWLPYPI3I557hNf2Vfb6OrfrOczg",19,1.8,8816,218,8598,"Sed ante. Vivamus tortor. Duis mattis egestas metus.",64,9282,95,3.2,6755,1214,5541
964,"Barabbas",1997,"https://www.youtube.com/embed/COTt1zvBUJk","https://encrypted-tbn0.gstatic.com/images?q=tbn:ANd9GcT3yd_NJLFNa8pH2NX8GufmbmYJmY751UxjTNcB2ALIMGhKfx94gQ",64,6.8,8382,156,8226,"Duis bibendum. Morbi non quam nec dui luctus rutrum. Nulla tellus.",34,2413,66,1.8,2323,3444,-1121
965,"Sgt. Bilko",1997,"https://www.youtube.com/embed/XtgCqMZofqM","https://encrypted-tbn0.gstatic.com/images?q=tbn:ANd9GcSaZZLwGXqiNU5rkhexU86wKZGzymZWTp2nKRDFdITh7rD7Jb6yGA",37,1.8,1360,3371,-2011,"Proin eu mi. Nulla ac enim. In tempor, turpis nec euismod scelerisque, quam turpis adipiscing lorem, vitae mattis nibh ligula nec sem.",70,8039,89,8.4,7715,2596,5119
966,"American Pie Presents The Naked Mile (American Pie 5: The Naked Mile)",1997,"https://www.youtube.com/embed/MNp1LPm3Krs","https://i.pinimg.com/236x/77/50/b3/7750b3ebe0787ae8e9beb7e2615e3b01.jpg",61,1.4,8377,3118,5259,"Quisque porta volutpat erat. Quisque erat eros, viverra eget, congue eget, semper rutrum, nulla. Nunc purus.",82,8039,61,1.8,2777,1214,1563
967,"From Beijing with Love",2008,"https://www.youtube.com/embed/4AEkzL2SvmI","https://encrypted-tbn0.gstatic.com/images?q=tbn:ANd9GcQ1aky5NsvfU2oObNVwH5j9ZHJNNcxRkRhHEYTh8yhtqNLPmxk0lA",19,3.2,753,1496,-743,"Quisque id justo sit amet sapien dignissim vestibulum. Vestibulum ante ipsum primis in faucibus orci luctus et ultrices posuere cubilia Curae; Nulla dapibus dolor vel est. Donec odio justo, sollicitudin ut, suscipit a, feugiat et, eros.",76,7702,80,5.1,5696,4712,984
968,"The Gaucho",2011,"https://www.youtube.com/embed/G9T_f7DjYho","https://encrypted-tbn0.gstatic.com/images?q=tbn:ANd9GcRmeUcg7O8EkPtcOaGTwx1hvLuj5TbCPLmfq_zT0IhPpcbOWbBUDA",59,1.2,698,4860,-4162,"Proin eu mi. Nulla ac enim. In tempor, turpis nec euismod scelerisque, quam turpis adipiscing lorem, vitae mattis nibh ligula nec sem.",26,3074,90,1,5160,4,5156
969,"Block-Heads",2003,"https://www.youtube.com/embed/zCecE7OyVMU","https://encrypted-tbn0.gstatic.com/images?q=tbn:ANd9GcQ--11hFR6GYIOagDhcOJiqKSIqKz7XB_wRhQklbSwf9d4k8lto",19,6.9,7762,8004,-242,"Praesent blandit. Nam nulla. Integer pede justo, lacinia eget, tincidunt eget, tempus vel, pede.",70,8851,7,5.9,4602,3527,1075
970,"Man Is Not a Bird (Covek nije tica)",2005,"https://www.youtube.com/embed/COTt1zvBUJk","https://encrypted-tbn0.gstatic.com/images?q=tbn:ANd9GcTTLFfQrJmhvXjL4d_udm6Z89QYglVi4hTEmbaDRdDoqHQsaQVg",3,3.2,7890,537,7353,"In quis justo. Maecenas rhoncus aliquam lacus. Morbi quis tortor id nulla ultrices aliquet.",64,5002,98,5.1,7900,361,7539
971,"Iceberg, L'",2002,"https://www.youtube.com/embed/6SO96lvWqzc","https://encrypted-tbn0.gstatic.com/images?q=tbn:ANd9GcRJqLpbXoWWpbGuNXVAuF8Iy2X8EFCKx-z2jPdj5XGEL_wrFgzY",43,2.4,8429,1898,6531,"Nulla ut erat id mauris vulputate elementum. Nullam varius. Nulla facilisi.",22,1528,36,2.4,8410,537,7873
972,"Talcum Powder",1996,"https://www.youtube.com/embed/Sw_5YPAf7Zs","https://encrypted-tbn0.gstatic.com/images?q=tbn:ANd9GcSi9aOrS5oPJ7A3vLqJaEpNsmPCxVAYNwpoAl_G9K7p6pLBjaxALw",81,6.9,9141,3527,5614,"Fusce consequat. Nulla nisl. Nunc nisl.",84,3119,82,6.1,2779,5515,-2736
973,"Babylon 5: In the Beginning",1997,"https://www.youtube.com/embed/Sw_5YPAf7Zs","https://encrypted-tbn0.gstatic.com/images?q=tbn:ANd9GcRWaaeSy6yTdILVOdHiDa9DWFAM4DhQ1JlJvUBR4vWbVoeZznD-",81,8.1,8496,772,7724,"Integer ac leo. Pellentesque ultrices mattis odio. Donec vitae nisi.",28,7612,70,3.2,2777,1865,912
974,"Elvis Meets Nixon",1994,"https://www.youtube.com/embed/Sw_5YPAf7Zs","https://encrypted-tbn0.gstatic.com/images?q=tbn:ANd9GcQaa7JH1TX7xtU8SpR35IjPOWF7HSujPYnfqJy-FlHEfxv6HXq3tQ",78,7.5,9389,2001,7388,"Sed ante. Vivamus tortor. Duis mattis egestas metus.",32,4091,55,3.2,8715,627,8088
975,"Dorado, El",2010,"https://www.youtube.com/embed/YWbrTLsplyA","https://encrypted-tbn0.gstatic.com/images?q=tbn:ANd9GcQ4tG7BC0SE2SNUji4NBAmTKKl13L-IuMZpkiEbQm0YeWk9Z1SQUg",62,4.1,698,1025,-327,"Curabitur in libero ut massa volutpat convallis. Morbi odio odio, elementum eu, interdum eu, tincidunt in, leo. Maecenas pulvinar lobortis est.",90,25,44,8.9,4324,831,3493
976,"Isolation",2005,"https://www.youtube.com/embed/MExr5cmGsC4","https://encrypted-tbn0.gstatic.com/images?q=tbn:ANd9GcSr9sVCqvsx-91eeqQvyCjpe4Fo7sap42UGJTn3IzdyIQVFy39R",38,3.6,132,879,-747,"Aliquam quis turpis eget elit sodales scelerisque. Mauris sit amet eros. Suspendisse accumsan tortor quis turpis.",64,8039,94,3.8,7762,218,7544
977,"Bill Cosby, Himself",2012,"https://www.youtube.com/embed/7C2Nad0aMPg","https://encrypted-tbn0.gstatic.com/images?q=tbn:ANd9GcSnUCe3jwoe6TiIdg0tv_j25Q3WHNDjeBfzqlYhOl70hy95_k9t1Q",70,1.5,9683,3371,6312,"Proin eu mi. Nulla ac enim. In tempor, turpis nec euismod scelerisque, quam turpis adipiscing lorem, vitae mattis nibh ligula nec sem.",100,1948,96,1.1,2883,4020,-1137
978,"The Last Seduction",1985,"https://www.youtube.com/embed/eqDHqOcXjRQ","https://encrypted-tbn0.gstatic.com/images?q=tbn:ANd9GcSJJAS-aY5yM_o538SFwYJKMI1ICZvCAEdnVZX59tINRulVx7aBpA",7,8.8,753,4020,-3267,"Proin eu mi. Nulla ac enim. In tempor, turpis nec euismod scelerisque, quam turpis adipiscing lorem, vitae mattis nibh ligula nec sem.",26,7481,30,3.1,753,3074,-2321
979,"Thoroughly Modern Millie",2011,"https://www.youtube.com/embed/YWbrTLsplyA","https://encrypted-tbn0.gstatic.com/images?q=tbn:ANd9GcQ_K_OlRU89USb4Vi53WsTFwqiEXKhfRUVw08lWTiH5XSmSISDDwg",66,6.8,6199,2965,3234,"Nulla ut erat id mauris vulputate elementum. Nullam varius. Nulla facilisi.",24,8851,35,4.1,692,2999,-2307
980,"Of Love and Shadows",2011,"https://www.youtube.com/embed/sZ8e_0i7UDk","https://encrypted-tbn0.gstatic.com/images?q=tbn:ANd9GcQhhglaTqXYejQ2b9TYl15F3E4pAgR1pWjyYyUTJgkHGuKsiWyHrw",34,6.8,9389,5228,4161,"Curabitur in libero ut massa volutpat convallis. Morbi odio odio, elementum eu, interdum eu, tincidunt in, leo. Maecenas pulvinar lobortis est.",44,8567,24,6.7,2777,6892,-4115
981,"Beyond Therapy",1988,"https://www.youtube.com/embed/YWbrTLsplyA","https://encrypted-tbn0.gstatic.com/images?q=tbn:ANd9GcRWaaeSy6yTdILVOdHiDa9DWFAM4DhQ1JlJvUBR4vWbVoeZznD-",4,1.8,7162,3563,3599,"Quisque porta volutpat erat. Quisque erat eros, viverra eget, congue eget, semper rutrum, nulla. Nunc purus.",96,1379,57,7.5,2987,7462,-4475
982,"Coming Down the Mountain",1997,"https://www.youtube.com/embed/oP-fRX_gB6o","https://encrypted-tbn0.gstatic.com/images?q=tbn:ANd9GcT5qYZ7WL1XpLSuZms35fvGdxwAwN8ZoDje7zRyyFHfFSsWWAHelQ",35,3.2,2034,1504,530,"Suspendisse potenti. In eleifend quam a odio. In hac habitasse platea dictumst.",32,694,69,1.8,8388,1741,6647
983,"Protector (Protektor)",2004,"https://www.youtube.com/embed/ee12SvnnrSw","https://encrypted-tbn0.gstatic.com/images?q=tbn:ANd9GcSOWY9FWNsfX_XrmFypiMILLGG-QtrQcxL8f5w3qsIiNjiSdC3x",18,8.1,9122,8629,493,"Suspendisse potenti. In eleifend quam a odio. In hac habitasse platea dictumst.",58,4869,70,4.8,9416,2308,7108
984,"Miami Vice",1985,"https://www.youtube.com/embed/LcepHRTWI18","https://images-na.ssl-images-amazon.com/images/I/41SFojuU1FL._SY600_.jpg",84,1.4,9496,3412,6084,"Proin leo odio, porttitor id, consequat in, consequat ut, nulla. Sed accumsan felis. Ut at dolor quis odio consequat varius.",62,2435,89,8.1,6275,1374,4901
985,"Babylon 5: In the Beginning",1994,"https://www.youtube.com/embed/ee1172yeqyE","https://encrypted-tbn0.gstatic.com/images?q=tbn:ANd9GcSi9aOrS5oPJ7A3vLqJaEpNsmPCxVAYNwpoAl_G9K7p6pLBjaxALw",77,9.6,6774,1592,5182,"Aliquam quis turpis eget elit sodales scelerisque. Mauris sit amet eros. Suspendisse accumsan tortor quis turpis.",70,8056,70,5.9,8437,3527,4910
986,"Isolation",2012,"https://www.youtube.com/embed/MpJEOpsVWtA","https://encrypted-tbn0.gstatic.com/images?q=tbn:ANd9GcTjDxlkO4SurlCq11A009Vm2yOW0XT4x5GHflg-pkVrTiqWURnydg",70,2.1,7900,3313,4587,"Sed ante. Vivamus tortor. Duis mattis egestas metus.",80,2840,56,8.5,3458,5206,-1748
987,"Bullet",2003,"https://www.youtube.com/embed/oNTzFnMXT3E","https://encrypted-tbn0.gstatic.com/images?q=tbn:ANd9GcSfenuQRjGbddBAE4j3I_GN73Ch-EI9uairOfxWWbLQYAluLoDWCQ",84,6.8,7383,2352,5031,"Quisque id justo sit amet sapien dignissim vestibulum. Vestibulum ante ipsum primis in faucibus orci luctus et ultrices posuere cubilia Curae; Nulla dapibus dolor vel est. Donec odio justo, sollicitudin ut, suscipit a, feugiat et, eros.",42,6858,56,5.9,9141,2489,6652
988,"The Prisoner",2004,"https://www.youtube.com/embed/oNTzFnMXT3E","https://encrypted-tbn0.gstatic.com/images?q=tbn:ANd9GcQvfJ-vLQ5TK13ND8sY6H-r6cm_4f3SnW_WAWn2vuX-nGh6F8JquQ",70,4.8,9683,5228,4455,"Sed ante. Vivamus tortor. Duis mattis egestas metus.",42,7690,70,1.2,753,831,-78
989,"When Time Ran Out...",1997,"https://www.youtube.com/embed/BQcvHEkGaEA","https://encrypted-tbn0.gstatic.com/images?q=tbn:ANd9GcSutU5UF40fwtxDcA61fL6VFTPKJYlaJOeUxSuI4qfpFQYO1KZ3",50,8.3,7683,1037,6646,"Morbi non lectus. Aliquam sit amet diam in magna bibendum imperdiet. Nullam orci pede, venenatis non, sodales sed, tincidunt eu, felis.",58,3074,84,3.4,7762,6366,1396
990,"The Paradine Case",2009,"https://www.youtube.com/embed/oP-fRX_gB6o","https://encrypted-tbn0.gstatic.com/images?q=tbn:ANd9GcRyMl7AW_r-FXiuqUSSUA5Mww484NZ8QAd_-vEbcfX2bB8j-uCn1g",70,5.1,6755,2311,4444,"Integer tincidunt ante vel ipsum. Praesent blandit lacinia erat. Vestibulum sed magna at nunc commodo placerat.",50,4907,41,6.7,9389,5228,4161
991,"Little Nikita",1996,"https://www.youtube.com/embed/BQcvHEkGaEA","https://encrypted-tbn0.gstatic.com/images?q=tbn:ANd9GcQ1aky5NsvfU2oObNVwH5j9ZHJNNcxRkRhHEYTh8yhtqNLPmxk0lA",19,3.2,7383,2352,5031,"Sed ante. Vivamus tortor. Duis mattis egestas metus.",30,8135,70,8.8,3019,3539,-520
992,"In the Line of Duty: The F.B.I. Murders",1979,"https://www.youtube.com/embed/nMVDQZ34joY","https://encrypted-tbn0.gstatic.com/images?q=tbn:ANd9GcTrBuPeRIXbqvHjWMwFg1aZvVkw71rsNVla5A067w7kiY-DPB7N",6,9.6,8446,8004,442,"Pellentesque at nulla. Suspendisse potenti. Cras in purus eu magna vulputate luctus.",62,3444,77,7.5,7162,6366,796
993,"The Browning Version",2012,"https://www.youtube.com/embed/REXXOGV1IIE","https://encrypted-tbn0.gstatic.com/images?q=tbn:ANd9GcTZlJW6ILTHoyypnMTvpWTFl3IhTXHYM5kQntofSVvdKEozMRsTxQ",28,2.1,2323,156,2167,"Pellentesque at nulla. Suspendisse potenti. Cras in purus eu magna vulputate luctus.",60,3119,26,7,8446,6885,1561
994,"Diary of a Shinjuku Thief (Shinjuku dorobo nikki)",2006,"https://www.youtube.com/embed/SF0w2B6DNUE","https://encrypted-tbn0.gstatic.com/images?q=tbn:ANd9GcSkP7ePajJciblvooQK7qTSV2J0ZdjBzPxrRi7NvBHdmOLYWeT4",49,5.7,3458,73,3385,"Pellentesque at nulla. Suspendisse potenti. Cras in purus eu magna vulputate luctus.",98,9857,40,6.8,9696,5515,4181
995,"Thunder Bay",2012,"https://www.youtube.com/embed/keo8PJecIEc","https://encrypted-tbn0.gstatic.com/images?q=tbn:ANd9GcR203qZ3CqJHkReGO_urfLpOmRqqwbZ6g8ZOVV-2aZbySbWl_abdg",80,2.1,9696,3539,6157,"Vestibulum quam sapien, varius ut, blandit non, interdum in, ante. Vestibulum ante ipsum primis in faucibus orci luctus et ultrices posuere cubilia Curae; Duis faucibus accumsan odio. Curabitur convallis.",86,6719,33,3.1,9141,1061,8080
996,"Man Is Not a Bird (Covek nije tica)",2005,"https://www.youtube.com/embed/8W6yYBAUxv4","https://encrypted-tbn0.gstatic.com/images?q=tbn:ANd9GcQ4tG7BC0SE2SNUji4NBAmTKKl13L-IuMZpkiEbQm0YeWk9Z1SQUg",87,3.1,3458,923,2535,"Praesent blandit. Nam nulla. Integer pede justo, lacinia eget, tincidunt eget, tempus vel, pede.",42,8363,70,5.1,3530,5228,-1698
997,"Little Nikita",1997,"https://www.youtube.com/embed/9g-j4wuEOPo","https://encrypted-tbn0.gstatic.com/images?q=tbn:ANd9GcRyMl7AW_r-FXiuqUSSUA5Mww484NZ8QAd_-vEbcfX2bB8j-uCn1g",61,8.9,6755,1865,4890,"Integer tincidunt ante vel ipsum. Praesent blandit lacinia erat. Vestibulum sed magna at nunc commodo placerat.",24,6632,80,7,8301,3371,4930
998,"From Beijing with Love",2006,"https://www.youtube.com/embed/COTt1zvBUJk","https://encrypted-tbn0.gstatic.com/images?q=tbn:ANd9GcQaa7JH1TX7xtU8SpR35IjPOWF7HSujPYnfqJy-FlHEfxv6HXq3tQ",20,2.8,284,5228,-4944,"Sed sagittis. Nam congue, risus semper porta volutpat, quam pede lobortis ligula, sit amet eleifend pede libero quis orci. Nullam molestie nibh in lectus.",50,8363,9,8.4,3923,213,3710
999,"Bird of Paradise",1999,"https://www.youtube.com/embed/7Yz10uCVNVk","https://encrypted-tbn0.gstatic.com/images?q=tbn:ANd9GcTjDxlkO4SurlCq11A009Vm2yOW0XT4x5GHflg-pkVrTiqWURnydg",28,7.7,5498,2001,3497,"Phasellus in felis. Donec semper sapien a libero. Nam dui.",44,6719,29,2.1,2987,3428,-441
1000,"Bullet",2006,"https://www.youtube.com/embed/oNTzFnMXT3E","https://encrypted-tbn0.gstatic.com/images?q=tbn:ANd9GcSxYkdQhkFdrUcKH8fJB2yXGC_mRCGuYTVOQUJTDJY0t9GQ7I2_",42,9.3,2269,5471,-3202,"Cras mi pede, malesuada in, imperdiet et, commodo vulputate, justo. In blandit ultrices enim. Lorem ipsum dolor sit amet, consectetuer adipiscing elit.",58,7146,26,4.7,2779,2311,468
1001,"Harry Potter and the Order of the Phoenix",1988,"https://www.youtube.com/embed/6SO96lvWqzc","https://encrypted-tbn0.gstatic.com/images?q=tbn:ANd9GcQ_K_OlRU89USb4Vi53WsTFwqiEXKhfRUVw08lWTiH5XSmSISDDwg",9,6.8,3923,4020,-97,"Mauris enim leo, rhoncus sed, vestibulum sit amet, cursus id, turpis. Integer aliquet, massa id lobortis convallis, tortor risus dapibus augue, vel accumsan tellus nisi eu orci. Mauris lacinia sapien quis libero.",100,2153,4,6.9,2481,5471,-2990
1002,"Transylvania",1998,"https://www.youtube.com/embed/sZ8e_0i7UDk","https://i.pinimg.com/736x/37/a0/99/37a099570abb65e478268af396315658--brochure-design-colour-combinations.jpg",68,3.2,5160,4020,1140,"Cum sociis natoque penatibus et magnis dis parturient montes, nascetur ridiculus mus. Vivamus vestibulum sagittis sapien. Cum sociis natoque penatibus et magnis dis parturient montes, nascetur ridiculus mus.",80,6777,84,2.4,5498,3074,2424
1003,"Bill Cosby, Himself",1996,"https://www.youtube.com/embed/YVYzxm_RqMg","https://encrypted-tbn0.gstatic.com/images?q=tbn:ANd9GcSaZZLwGXqiNU5rkhexU86wKZGzymZWTp2nKRDFdITh7rD7Jb6yGA",70,1.2,6869,2606,4263,"Curabitur in libero ut massa volutpat convallis. Morbi odio odio, elementum eu, interdum eu, tincidunt in, leo. Maecenas pulvinar lobortis est.",96,3776,34,7.2,3411,2311,1100
1004,"The Stars Fell on Henrietta",1997,"https://www.youtube.com/embed/1ywA8TtwJ50","https://encrypted-tbn0.gstatic.com/images?q=tbn:ANd9GcTXDcq3lfWD_dPTVpQSNf6H8Sg12ilkGrxNouqLt7Nra0lQvOOO",29,7.2,3019,1545,1474,"In congue. Etiam justo. Etiam pretium iaculis justo.",88,1277,7,1.2,4602,3881,721
1005,"Gorko!",1996,"https://www.youtube.com/embed/ka3J1sUhQ4M","https://encrypted-tbn0.gstatic.com/images?q=tbn:ANd9GcTVx6QbLHPUKkVSj1TkaOANhnRfjtIXHhKnHSaIR2y3RkCgry-X",56,2.4,1555,218,1337,"In congue. Etiam justo. Etiam pretium iaculis justo.",100,4869,20,1.4,9122,3881,5241
1006,"Azumi 2: Death or Love",2000,"https://www.youtube.com/embed/qqlEGYo0xCA","https://encrypted-tbn0.gstatic.com/images?q=tbn:ANd9GcQtbFBdNfjGVCo1GPJC_9PUkUc7wRIwwh0PMwS76SEP_QTtAyat",55,8.1,6275,1733,4542,"Donec diam neque, vestibulum eget, vulputate ut, ultrices vel, augue. Vestibulum ante ipsum primis in faucibus orci luctus et ultrices posuere cubilia Curae; Donec pharetra, magna vestibulum aliquet ultrices, erat tortor sollicitudin mi, sit amet lobortis sapien sapien non mi. Integer ac neque.",26,25,3,1.2,9683,1374,8309
1007,"Gunday",2003,"https://www.youtube.com/embed/6Ui6m_eEEOI","https://encrypted-tbn0.gstatic.com/images?q=tbn:ANd9GcQzrbGfcJ8GKN78hn-r1fcQf4zH81e0MlsuOddkBJvhC5RvfF2DNw",66,5.1,118,3539,-3421,"In congue. Etiam justo. Etiam pretium iaculis justo.",52,1948,83,8.9,6734,73,6661
1008,"Fido",2006,"https://www.youtube.com/embed/yuYoFVHkvIA","https://encrypted-tbn0.gstatic.com/images?q=tbn:ANd9GcSkjHflFbGJwA3Dk6FW71ynZ5C6z_y9dkcX7Q0Q-2NSkRIUerlH",77,7,1555,6554,-4999,"In hac habitasse platea dictumst. Etiam faucibus cursus urna. Ut tellus.",66,9441,49,7.7,7162,1733,5429
1009,"Barabbas",2011,"https://www.youtube.com/embed/fkr_djVWStU","https://encrypted-tbn0.gstatic.com/images?q=tbn:ANd9GcSfenuQRjGbddBAE4j3I_GN73Ch-EI9uairOfxWWbLQYAluLoDWCQ",30,7.7,9585,3881,5704,"Proin interdum mauris non ligula pellentesque ultrices. Phasellus id sapien in sapien iaculis congue. Vivamus metus arcu, adipiscing molestie, hendrerit at, vulputate vitae, nisl.",26,8135,89,3.6,8496,1025,7471
1010,"Talcum Powder",1989,"https://www.youtube.com/embed/giIs-AEAX6Y","https://encrypted-tbn0.gstatic.com/images?q=tbn:ANd9GcSBKrAU7qHXZ_vqij5HmW3xvTgSZ9qA7lT4fxAsUEXHGvWHHXai",80,5.9,9585,2965,6620,"Sed ante. Vivamus tortor. Duis mattis egestas metus.",96,694,89,1,8429,285,8144
1011,"Lust for Gold",2011,"https://www.youtube.com/embed/EKGATzNnr8c","https://encrypted-tbn0.gstatic.com/images?q=tbn:ANd9GcT11kibbY7ZQKvhvKatIRRKfv-n-n77Ve-QuVdMOoMg-fol_k9j",6,9.6,118,879,-761,"Proin interdum mauris non ligula pellentesque ultrices. Phasellus id sapien in sapien iaculis congue. Vivamus metus arcu, adipiscing molestie, hendrerit at, vulputate vitae, nisl.",60,1649,95,7.5,284,9584,-9300
1012,"The Law of the Weakest",1998,"https://www.youtube.com/embed/6SO96lvWqzc","https://encrypted-tbn0.gstatic.com/images?q=tbn:ANd9GcQ_K_OlRU89USb4Vi53WsTFwqiEXKhfRUVw08lWTiH5XSmSISDDwg",18,8.8,1795,5206,-3411,"Donec diam neque, vestibulum eget, vulputate ut, ultrices vel, augue. Vestibulum ante ipsum primis in faucibus orci luctus et ultrices posuere cubilia Curae; Donec pharetra, magna vestibulum aliquet ultrices, erat tortor sollicitudin mi, sit amet lobortis sapien sapien non mi. Integer ac neque.",80,5258,90,1.2,7256,3539,3717
1013,"Blow Out",2010,"https://www.youtube.com/embed/VccwBGgyzP4","https://encrypted-tbn0.gstatic.com/images?q=tbn:ANd9GcS0uoN_00qCw12_q1GgGAdcbA-6sp6JzFguYZMxLObI8Ydh9OBk",75,8.9,9585,2352,7233,"Quisque porta volutpat erat. Quisque erat eros, viverra eget, congue eget, semper rutrum, nulla. Nunc purus.",56,3455,28,5.8,7162,2311,4851
1014,"Vicky Donor",1987,"https://www.youtube.com/embed/mAX1oGLvMAA","https://encrypted-tbn0.gstatic.com/images?q=tbn:ANd9GcTjDxlkO4SurlCq11A009Vm2yOW0XT4x5GHflg-pkVrTiqWURnydg",77,5.9,3530,627,2903,"Maecenas tristique, est et tempus semper, est quam pharetra magna, ac consequat metus sapien ut nunc. Vestibulum ante ipsum primis in faucibus orci luctus et ultrices posuere cubilia Curae; Mauris viverra diam vitae quam. Suspendisse potenti.",100,4526,62,5.4,8611,1575,7036
1015,"Transylvania",2009,"https://www.youtube.com/embed/6SO96lvWqzc","https://encrypted-tbn0.gstatic.com/images?q=tbn:ANd9GcQ1RC08Lpg31X2H7K5Uphlh7PGrzq7-JtVNzeSh-4UIh-JZbUaCDg",57,3.1,9496,2965,6531,"Proin leo odio, porttitor id, consequat in, consequat ut, nulla. Sed accumsan felis. Ut at dolor quis odio consequat varius.",84,7146,70,2.8,6386,5206,1180
1016,"The Indian Runner",1989,"https://www.youtube.com/embed/iOMxsy8S7hk","https://encrypted-tbn0.gstatic.com/images?q=tbn:ANd9GcRUMZIkgEW4ZtYyXTgo6uGdYksy7dreOkd-zJRc1uGna-GAnU3SDQ",81,2.1,5696,5284,412,"Praesent blandit. Nam nulla. Integer pede justo, lacinia eget, tincidunt eget, tempus vel, pede.",100,2866,61,6.3,7762,2001,5761
1017,"Bullet",2011,"https://www.youtube.com/embed/vuzplFd3YVY","https://encrypted-tbn0.gstatic.com/images?q=tbn:ANd9GcTTLFfQrJmhvXjL4d_udm6Z89QYglVi4hTEmbaDRdDoqHQsaQVg",83,1.7,8226,2965,5261,"Phasellus sit amet erat. Nulla tempus. Vivamus in felis eu sapien cursus vestibulum.",86,1620,88,3.2,7890,213,7677
1018,"Quand je serai petit",1987,"https://www.youtube.com/embed/MaI-4NepPfU","https://encrypted-tbn0.gstatic.com/images?q=tbn:ANd9GcSJJAS-aY5yM_o538SFwYJKMI1ICZvCAEdnVZX59tINRulVx7aBpA",37,7.8,8437,2308,6129,"Fusce posuere felis sed lacus. Morbi sem mauris, laoreet ut, rhoncus aliquet, pulvinar sed, nisl. Nunc rhoncus dui vel sem.",28,4526,66,2.4,6469,263,6206
1019,"Fido",2010,"https://www.youtube.com/embed/vuzplFd3YVY","https://encrypted-tbn0.gstatic.com/images?q=tbn:ANd9GcSxYkdQhkFdrUcKH8fJB2yXGC_mRCGuYTVOQUJTDJY0t9GQ7I2_",19,5.1,2777,772,2005,"Proin leo odio, porttitor id, consequat in, consequat ut, nulla. Sed accumsan felis. Ut at dolor quis odio consequat varius.",70,7121,95,6,8611,4020,4591
1020,"The Cell 2",1997,"https://www.youtube.com/embed/G9T_f7DjYho","https://encrypted-tbn0.gstatic.com/images?q=tbn:ANd9GcQ4tG7BC0SE2SNUji4NBAmTKKl13L-IuMZpkiEbQm0YeWk9Z1SQUg",6,6.3,5529,6427,-898,"Aliquam quis turpis eget elit sodales scelerisque. Mauris sit amet eros. Suspendisse accumsan tortor quis turpis.",76,8838,98,2,3801,1898,1903
1021,"Murder Ahoy",2000,"https://www.youtube.com/embed/VUEaDUyeTR8","https://encrypted-tbn0.gstatic.com/images?q=tbn:ANd9GcTppyYABMyqegOc4I6b3NS0iUaX0R6Cy1-PlahMrPPUzzqPNux9Gg",66,4.8,8410,1822,6588,"Maecenas tristique, est et tempus semper, est quam pharetra magna, ac consequat metus sapien ut nunc. Vestibulum ante ipsum primis in faucibus orci luctus et ultrices posuere cubilia Curae; Mauris viverra diam vitae quam. Suspendisse potenti.",26,1442,77,8.4,692,2311,-1619
1022,"Quand je serai petit",1997,"https://www.youtube.com/embed/B12REtkl2KY","https://encrypted-tbn0.gstatic.com/images?q=tbn:ANd9GcQ1NxrNXukXKIzYZ8UbVazSnR-5741v5UDQPpMMVUvn_2I28fMZ",75,6.7,5498,2198,3300,"Morbi non lectus. Aliquam sit amet diam in magna bibendum imperdiet. Nullam orci pede, venenatis non, sodales sed, tincidunt eu, felis.",52,2629,64,6.8,2847,4125,-1278
1023,"Beyond Therapy",1999,"https://www.youtube.com/embed/eAIjuMHKEiA","https://encrypted-tbn0.gstatic.com/images?q=tbn:ANd9GcSOWY9FWNsfX_XrmFypiMILLGG-QtrQcxL8f5w3qsIiNjiSdC3x",50,9.3,8429,5471,2958,"Praesent blandit. Nam nulla. Integer pede justo, lacinia eget, tincidunt eget, tempus vel, pede.",62,962,80,2.1,6199,4124,2075
1024,"Little Boy Blue",1999,"https://www.youtube.com/embed/l-u3PdA-rpY","https://encrypted-tbn0.gstatic.com/images?q=tbn:ANd9GcR_EXv1N1pkhMX0O3KAJXlTgC0_KL4WpSRDxUzH2CO9RPypuvxDAw",89,8.4,2409,831,1578,"Proin eu mi. Nulla ac enim. In tempor, turpis nec euismod scelerisque, quam turpis adipiscing lorem, vitae mattis nibh ligula nec sem.",82,9441,49,6.2,5541,5515,26
1025,"Fido",1993,"https://www.youtube.com/embed/KbZ3TVEkuDY","https://encrypted-tbn0.gstatic.com/images?q=tbn:ANd9GcQInYhbERWHKRlaq1eJAqZqaGQ9zndtpCyGofdPFToPGHuZUGCS",98,3.4,1360,2617,-1257,"Cum sociis natoque penatibus et magnis dis parturient montes, nascetur ridiculus mus. Vivamus vestibulum sagittis sapien. Cum sociis natoque penatibus et magnis dis parturient montes, nascetur ridiculus mus.",98,8838,66,6.9,132,3313,-3181
1026,"U2: Rattle and Hum",2011,"https://www.youtube.com/embed/_c3WIprIGHE","https://encrypted-tbn0.gstatic.com/images?q=tbn:ANd9GcSZ6r6rDjMvQsp22jqT0ZPe_z-oKhAWQcjwgB5egzck4lqzLHYHCg",28,6.9,9141,1374,7767,"Suspendisse potenti. In eleifend quam a odio. In hac habitasse platea dictumst.",50,1379,20,3.2,4324,3251,1073
1027,"Holy Flame of the Martial World (Wu lin sheng huo jin)",1997,"https://www.youtube.com/embed/keo8PJecIEc","https://encrypted-tbn0.gstatic.com/images?q=tbn:ANd9GcQvfJ-vLQ5TK13ND8sY6H-r6cm_4f3SnW_WAWn2vuX-nGh6F8JquQ",57,3.6,284,7219,-6935,"Integer tincidunt ante vel ipsum. Praesent blandit lacinia erat. Vestibulum sed magna at nunc commodo placerat.",62,9282,10,5.1,2987,1983,1004
1028,"Little Boy Blue",2000,"https://www.youtube.com/embed/h-k0-Z9b4Cw","https://i.pinimg.com/236x/3b/29/73/3b2973cc00e87a821ad68647747259be--pattern-texture-paints.jpg",38,4.3,8454,2965,5489,"Proin eu mi. Nulla ac enim. In tempor, turpis nec euismod scelerisque, quam turpis adipiscing lorem, vitae mattis nibh ligula nec sem.",52,1277,94,3.6,198,285,-87
1029,"7 Women (a.k.a. Seven Women)",1985,"https://www.youtube.com/embed/oNTzFnMXT3E","https://encrypted-tbn0.gstatic.com/images?q=tbn:ANd9GcTpzv6ZkKQ_5fFlx242_ZFGnV3MuzyUBrlVMhbcTFBKJGCr7XxS",57,9.3,6275,2198,4077,"Proin leo odio, porttitor id, consequat in, consequat ut, nulla. Sed accumsan felis. Ut at dolor quis odio consequat varius.",100,8567,70,4.1,284,3527,-3243
1030,"The Indian Runner",2008,"https://www.youtube.com/embed/dfUJm6XgD7g","https://encrypted-tbn0.gstatic.com/images?q=tbn:ANd9GcRmeUcg7O8EkPtcOaGTwx1hvLuj5TbCPLmfq_zT0IhPpcbOWbBUDA",70,7,3411,4,3407,"Morbi non lectus. Aliquam sit amet diam in magna bibendum imperdiet. Nullam orci pede, venenatis non, sodales sed, tincidunt eu, felis.",44,3119,18,6.1,7162,562,6600
1031,"The Paradine Case",1984,"https://www.youtube.com/embed/DIOW-kR_ams","https://encrypted-tbn0.gstatic.com/images?q=tbn:ANd9GcRauFfIne8mHbF9MCn-LxY8C6gHqalPefcj6s8z0B9JZwEnD5A4",65,4.7,3417,3412,5,"Quisque porta volutpat erat. Quisque erat eros, viverra eget, congue eget, semper rutrum, nulla. Nunc purus.",26,9857,59,3.4,5541,3607,1934
1032,"Alive",2012,"https://www.youtube.com/embed/DyQ8PoBV_Vo","https://encrypted-tbn0.gstatic.com/images?q=tbn:ANd9GcQ_K_OlRU89USb4Vi53WsTFwqiEXKhfRUVw08lWTiH5XSmSISDDwg",37,7.2,9822,1822,8000,"Proin eu mi. Nulla ac enim. In tempor, turpis nec euismod scelerisque, quam turpis adipiscing lorem, vitae mattis nibh ligula nec sem.",62,735,57,2,5704,2311,3393
1033,"The Land Before Time XII: The Great Day of the Flyers",1997,"https://www.youtube.com/embed/eAIjuMHKEiA","https://encrypted-tbn0.gstatic.com/images?q=tbn:ANd9GcRxLYJSuzc9AAuuJ3R1HulbKM_T8_whdwPZQj7VyYonHOME6fYq",81,9,6579,5,6574,"In hac habitasse platea dictumst. Etiam faucibus cursus urna. Ut tellus.",38,9431,57,2.4,4108,2617,1491
1034,"The Tic Code",1997,"https://www.youtube.com/embed/zCecE7OyVMU","https://encrypted-tbn0.gstatic.com/images?q=tbn:ANd9GcRyMl7AW_r-FXiuqUSSUA5Mww484NZ8QAd_-vEbcfX2bB8j-uCn1g",44,5.9,692,5284,-4592,"Pellentesque at nulla. Suspendisse potenti. Cras in purus eu magna vulputate luctus.",66,2682,56,6.1,3019,772,2247
1035,"Harry Potter and the Order of the Phoenix",1998,"https://www.youtube.com/embed/ee12SvnnrSw","https://encrypted-tbn0.gstatic.com/images?q=tbn:ANd9GcRWaaeSy6yTdILVOdHiDa9DWFAM4DhQ1JlJvUBR4vWbVoeZznD-",84,1.4,3801,1504,2297,"Phasellus sit amet erat. Nulla tempus. Vivamus in felis eu sapien cursus vestibulum.",50,2435,11,4.1,6774,5515,1259
1036,"King Kong",1997,"https://www.youtube.com/embed/B12REtkl2KY","https://encrypted-tbn0.gstatic.com/images?q=tbn:ANd9GcTt-58zOD-K4oKQ0AbvYduMdi-NxFRYLjx9Maf9ECQJMZkvfanqUw",88,8.3,9822,2240,7582,"Sed ante. Vivamus tortor. Duis mattis egestas metus.",80,223,80,9.5,4324,2617,1707
1037,"Barabbas",1989,"https://www.youtube.com/embed/MNp1LPm3Krs","https://encrypted-tbn0.gstatic.com/images?q=tbn:ANd9GcQ1aky5NsvfU2oObNVwH5j9ZHJNNcxRkRhHEYTh8yhtqNLPmxk0lA",36,7.7,7715,4712,3003,"Cras mi pede, malesuada in, imperdiet et, commodo vulputate, justo. In blandit ultrices enim. Lorem ipsum dolor sit amet, consectetuer adipiscing elit.",42,7498,64,4.9,6275,4020,2255
1038,"The Long Voyage Home",2012,"https://www.youtube.com/embed/oNTzFnMXT3E","https://encrypted-tbn0.gstatic.com/images?q=tbn:ANd9GcR6OdK3cVIVUn07PmO7zFQb1JyTfdi6L4FwxFWOD9dfwTwN4hEt",29,5.7,5954,2001,3953,"Integer ac leo. Pellentesque ultrices mattis odio. Donec vitae nisi.",48,223,49,4.2,2733,831,1902
1039,"Vicky Donor",1997,"https://www.youtube.com/embed/giIs-AEAX6Y","https://i.pinimg.com/236x/77/50/b3/7750b3ebe0787ae8e9beb7e2615e3b01.jpg",28,8.1,3019,5515,-2496,"Quisque porta volutpat erat. Quisque erat eros, viverra eget, congue eget, semper rutrum, nulla. Nunc purus.",68,7481,70,2.1,8382,1374,7008
1040,"Card Subject To Change",2003,"https://www.youtube.com/embed/ka3J1sUhQ4M","https://encrypted-tbn0.gstatic.com/images?q=tbn:ANd9GcQ1NxrNXukXKIzYZ8UbVazSnR-5741v5UDQPpMMVUvn_2I28fMZ",9,3.8,8715,2352,6363,"Quisque porta volutpat erat. Quisque erat eros, viverra eget, congue eget, semper rutrum, nulla. Nunc purus.",96,9857,60,3.4,8496,879,7617
1041,"Sky Fighters (Les Chevaliers Du Ciel)",2008,"https://www.youtube.com/embed/7C2Nad0aMPg","https://encrypted-tbn0.gstatic.com/images?q=tbn:ANd9GcS_NoH0Aw_5YFsBFwfBPn_O7YPHXumI5V3iQ2s7B-3zPU_7sSm1gA",56,9.3,1795,4,1791,"In congue. Etiam justo. Etiam pretium iaculis justo.",88,1948,62,7,3801,4124,-323
1042,"Thoroughly Modern Millie",2009,"https://www.youtube.com/embed/iaM3y7uDL90","https://encrypted-tbn0.gstatic.com/images?q=tbn:ANd9GcRUMZIkgEW4ZtYyXTgo6uGdYksy7dreOkd-zJRc1uGna-GAnU3SDQ",56,8.4,5954,1061,4893,"Praesent id massa id nisl venenatis lacinia. Aenean sit amet justo. Morbi ut odio.",26,7481,49,1.4,2987,2308,679
1043,"Operation 'Y' & Other Shurik's Adventures",2009,"https://www.youtube.com/embed/dfUJm6XgD7g","https://encrypted-tbn0.gstatic.com/images?q=tbn:ANd9GcRWaaeSy6yTdILVOdHiDa9DWFAM4DhQ1JlJvUBR4vWbVoeZznD-",98,7.7,9122,3412,5710,"Curabitur in libero ut massa volutpat convallis. Morbi odio odio, elementum eu, interdum eu, tincidunt in, leo. Maecenas pulvinar lobortis est.",38,5002,34,5.1,7900,1592,6308
1044,"The Innocent",2003,"https://www.youtube.com/embed/mAX1oGLvMAA","https://encrypted-tbn0.gstatic.com/images?q=tbn:ANd9GcTlHaTq59e08Zugqn9ZX71XQYUOtuUGEQ9Mkl_HR1NmuSBceL7O",80,5.1,6469,3563,2906,"In congue. Etiam justo. Etiam pretium iaculis justo.",30,5410,69,9.7,6386,2711,3675
1045,"Escaflowne: The Movie (Escaflowne)",1997,"https://www.youtube.com/embed/c4O-c4OycPM","https://encrypted-tbn0.gstatic.com/images?q=tbn:ANd9GcSC_qEbYtBeELogQVPTeiWNRbcOXlYKbMYmMPaG67T_yrWKEiTV",26,3.2,7256,2999,4257,"Sed ante. Vivamus tortor. Duis mattis egestas metus.",50,1620,13,5.9,7900,2777,5123
1046,"Diary of a Shinjuku Thief (Shinjuku dorobo nikki)",1993,"https://www.youtube.com/embed/3svtRyLq3b0","https://encrypted-tbn0.gstatic.com/images?q=tbn:ANd9GcQ5LAO-oqK_jHF33R_asKWptHCRYc_456jcsgrngpU6q8htwl24",64,9.3,4324,6427,-2103,"Sed sagittis. Nam congue, risus semper porta volutpat, quam pede lobortis ligula, sit amet eleifend pede libero quis orci. Nullam molestie nibh in lectus.",74,6858,56,9.5,1360,898,462
1047,"The Wrong Move",1999,"https://www.youtube.com/embed/ka3J1sUhQ4M","https://encrypted-tbn0.gstatic.com/images?q=tbn:ANd9GcR6OdK3cVIVUn07PmO7zFQb1JyTfdi6L4FwxFWOD9dfwTwN4hEt",78,8.3,2777,156,2621,"Maecenas leo odio, condimentum id, luctus nec, molestie sed, justo. Pellentesque viverra pede ac diam. Cras pellentesque volutpat dui.",40,607,88,5.9,8454,3539,4915
1048,"Escaflowne: The Movie (Escaflowne)",1997,"https://www.youtube.com/embed/1ywA8TtwJ50","https://encrypted-tbn0.gstatic.com/images?q=tbn:ANd9GcTsjOFvygMO8x-qvjqCJz2LIuSNcJ3SwoL3PgjTz-9CZFQxNyzGng",88,9.6,9141,213,8928,"Proin eu mi. Nulla ac enim. In tempor, turpis nec euismod scelerisque, quam turpis adipiscing lorem, vitae mattis nibh ligula nec sem.",42,2682,95,3.1,8429,562,7867
1049,"Of Love and Shadows",2005,"https://www.youtube.com/embed/4AEkzL2SvmI","https://encrypted-tbn0.gstatic.com/images?q=tbn:ANd9GcQvfJ-vLQ5TK13ND8sY6H-r6cm_4f3SnW_WAWn2vuX-nGh6F8JquQ",38,3.2,8429,2240,6189,"Cum sociis natoque penatibus et magnis dis parturient montes, nascetur ridiculus mus. Vivamus vestibulum sagittis sapien. Cum sociis natoque penatibus et magnis dis parturient montes, nascetur ridiculus mus.",50,7702,45,3.2,6199,562,5637
1050,"The Gaucho",2012,"https://www.youtube.com/embed/REXXOGV1IIE","https://encrypted-tbn0.gstatic.com/images?q=tbn:ANd9GcRXW_MDHretVBvFBnfeqtLtE86uQkY-GTeOH_gP8OZY1Znu6a86qg",37,3.2,7900,5209,2691,"Proin eu mi. Nulla ac enim. In tempor, turpis nec euismod scelerisque, quam turpis adipiscing lorem, vitae mattis nibh ligula nec sem.",72,6632,50,1.7,5943,1590,4353
1051,"Coming Down the Mountain",2000,"https://www.youtube.com/embed/dfUJm6XgD7g","https://encrypted-tbn0.gstatic.com/images?q=tbn:ANd9GcQYYT2HR82Tm6jDN6B_0-JbBC3HMcVQoxrwz0iiWHkiPx0sXczovQ",96,8.3,8816,4125,4691,"Proin leo odio, porttitor id, consequat in, consequat ut, nulla. Sed accumsan felis. Ut at dolor quis odio consequat varius.",52,8056,90,6.7,6869,627,6242
1052,"Operation 'Y' & Other Shurik's Adventures",1989,"https://www.youtube.com/embed/ee1172yeqyE","https://encrypted-tbn0.gstatic.com/images?q=tbn:ANd9GcRmeUcg7O8EkPtcOaGTwx1hvLuj5TbCPLmfq_zT0IhPpcbOWbBUDA",44,5.1,3923,1374,2549,"Cras non velit nec nisi vulputate nonummy. Maecenas tincidunt lacus at velit. Vivamus vel nulla eget eros elementum pellentesque.",36,4799,70,8.9,4108,6366,-2258
1053,"Iceberg, L'",2007,"https://www.youtube.com/embed/DIOW-kR_ams","https://encrypted-tbn0.gstatic.com/images?q=tbn:ANd9GcSmZDfgAQh9gNhDHM4YtECFcKd6iXDTMrn-PXI6Wylc9Lddn5ah-w",78,5.7,7162,6554,608,"Praesent blandit. Nam nulla. Integer pede justo, lacinia eget, tincidunt eget, tempus vel, pede.",82,1277,98,3.2,8301,2001,6300
1054,"The Gaucho",2004,"https://www.youtube.com/embed/9g-j4wuEOPo","https://encrypted-tbn0.gstatic.com/images?q=tbn:ANd9GcTppyYABMyqegOc4I6b3NS0iUaX0R6Cy1-PlahMrPPUzzqPNux9Gg",77,1.2,9141,1822,7319,"Mauris enim leo, rhoncus sed, vestibulum sit amet, cursus id, turpis. Integer aliquet, massa id lobortis convallis, tortor risus dapibus augue, vel accumsan tellus nisi eu orci. Mauris lacinia sapien quis libero.",56,5537,28,1.7,6275,3421,2854
1055,"Fair Game",2009,"https://www.youtube.com/embed/78ozCL4sQoI","https://encrypted-tbn0.gstatic.com/images?q=tbn:ANd9GcQT7MRD7KMXMfYFZ3Qi33LI-_bu1Q0DxOyhQgqolg06W2PrTbVuWg",42,9,5542,7462,-1920,"Cras mi pede, malesuada in, imperdiet et, commodo vulputate, justo. In blandit ultrices enim. Lorem ipsum dolor sit amet, consectetuer adipiscing elit.",60,93,31,2.8,7890,923,6967
1056,"Rabid Grannies (Mémés cannibales, Les)",2011,"https://www.youtube.com/embed/3_bUymlkSuA","https://i.pinimg.com/236x/5f/f6/69/5ff6693c3694f55e8ed9738084c4c6b1--d-design-design-concepts.jpg",81,1,3923,2240,1683,"Praesent blandit. Nam nulla. Integer pede justo, lacinia eget, tincidunt eget, tempus vel, pede.",56,6593,62,1.8,118,54,64
1057,"Zatoichi the Outlaw (Zatôichi rôyaburi) (Zatôichi 16)",2001,"https://www.youtube.com/embed/3svtRyLq3b0","https://encrypted-tbn0.gstatic.com/images?q=tbn:ANd9GcT3yd_NJLFNa8pH2NX8GufmbmYJmY751UxjTNcB2ALIMGhKfx94gQ",55,3.2,2323,4712,-2389,"Sed ante. Vivamus tortor. Duis mattis egestas metus.",30,281,35,2.8,5498,8629,-3131
1058,"Block-Heads",2001,"https://www.youtube.com/embed/MpJEOpsVWtA","https://encrypted-tbn0.gstatic.com/images?q=tbn:ANd9GcSkP7ePajJciblvooQK7qTSV2J0ZdjBzPxrRi7NvBHdmOLYWeT4",26,8.4,5160,831,4329,"Morbi non lectus. Aliquam sit amet diam in magna bibendum imperdiet. Nullam orci pede, venenatis non, sodales sed, tincidunt eu, felis.",36,9164,22,9,5541,2606,2935
1059,"Blow Out",1999,"https://www.youtube.com/embed/iW3t_wUDG5U","https://encrypted-tbn0.gstatic.com/images?q=tbn:ANd9GcSr9sVCqvsx-91eeqQvyCjpe4Fo7sap42UGJTn3IzdyIQVFy39R",42,4.6,1555,772,783,"Cras non velit nec nisi vulputate nonummy. Maecenas tincidunt lacus at velit. Vivamus vel nulla eget eros elementum pellentesque.",84,3441,49,5.7,12,6427,-6415
1060,"The Long Voyage Home",2010,"https://www.youtube.com/embed/kWuwuQ0X9OA","https://encrypted-tbn0.gstatic.com/images?q=tbn:ANd9GcT5qYZ7WL1XpLSuZms35fvGdxwAwN8ZoDje7zRyyFHfFSsWWAHelQ",55,2.4,2883,1037,1846,"Aliquam quis turpis eget elit sodales scelerisque. Mauris sit amet eros. Suspendisse accumsan tortor quis turpis.",90,8135,68,4.8,2269,537,1732
1061,"Payday",1994,"https://www.youtube.com/embed/G9T_f7DjYho","https://encrypted-tbn0.gstatic.com/images?q=tbn:ANd9GcTVx6QbLHPUKkVSj1TkaOANhnRfjtIXHhKnHSaIR2y3RkCgry-X",66,1,1795,73,1722,"Aliquam quis turpis eget elit sodales scelerisque. Mauris sit amet eros. Suspendisse accumsan tortor quis turpis.",52,962,26,1.2,2883,627,2256
1062,"When Time Ran Out...",1999,"https://www.youtube.com/embed/DyQ8PoBV_Vo","https://encrypted-tbn0.gstatic.com/images?q=tbn:ANd9GcQvLz9_jwOs-MucEN-bWUhjq9aaYyfVvyNoFoGgGFdFJBMuXq1yqw",33,2.1,5943,6885,-942,"Integer tincidunt ante vel ipsum. Praesent blandit lacinia erat. Vestibulum sed magna at nunc commodo placerat.",44,9885,98,1.8,6801,1214,5587
1063,"Sgt. Bilko",2001,"https://www.youtube.com/embed/KbZ3TVEkuDY","https://encrypted-tbn0.gstatic.com/images?q=tbn:ANd9GcRauFfIne8mHbF9MCn-LxY8C6gHqalPefcj6s8z0B9JZwEnD5A4",26,2.1,1360,1741,-381,"Maecenas ut massa quis augue luctus tincidunt. Nulla mollis molestie lorem. Quisque ut erat.",30,8838,98,8.1,7162,2443,4719
1064,"Second Wind (Le deuxième souffle) (Second Breath)",1999,"https://www.youtube.com/embed/i6ilL5z6cjA","https://encrypted-tbn0.gstatic.com/images?q=tbn:ANd9GcSfdl_pNap7w4wYTP7dhiozrcmHAmCcADuvkKlsj19tBpxYkq60LA",60,2.9,7683,1061,6622,"Morbi porttitor lorem id ligula. Suspendisse ornare consequat lectus. In est risus, auctor sed, tristique in, tempus sit amet, sem.",26,2682,31,4.8,9122,2999,6123
1065,"From Beijing with Love",1986,"https://www.youtube.com/embed/uaTAhjdaEuY","https://encrypted-tbn0.gstatic.com/images?q=tbn:ANd9GcSJJAS-aY5yM_o538SFwYJKMI1ICZvCAEdnVZX59tINRulVx7aBpA",95,1.8,3801,3313,488,"Lorem ipsum dolor sit amet, consectetuer adipiscing elit. Proin risus. Praesent lectus.",86,9282,61,3.4,6469,3527,2942
1066,"Dr. Jekyll and Ms. Hyde",2000,"https://www.youtube.com/embed/THq6KlWgiqw","https://encrypted-tbn0.gstatic.com/images?q=tbn:ANd9GcQtbFBdNfjGVCo1GPJC_9PUkUc7wRIwwh0PMwS76SEP_QTtAyat",22,9,4602,3648,954,"Proin leo odio, porttitor id, consequat in, consequat ut, nulla. Sed accumsan felis. Ut at dolor quis odio consequat varius.",30,9164,62,7,698,156,542
1067,"Aloft",2010,"https://www.youtube.com/embed/oNTzFnMXT3E","https://encrypted-tbn0.gstatic.com/images?q=tbn:ANd9GcQzrbGfcJ8GKN78hn-r1fcQf4zH81e0MlsuOddkBJvhC5RvfF2DNw",30,7.8,5146,2777,2369,"Quisque id justo sit amet sapien dignissim vestibulum. Vestibulum ante ipsum primis in faucibus orci luctus et ultrices posuere cubilia Curae; Nulla dapibus dolor vel est. Donec odio justo, sollicitudin ut, suscipit a, feugiat et, eros.",32,2629,42,1.1,7890,537,7353
1068,"Second Wind (Le deuxième souffle) (Second Breath)",1997,"https://www.youtube.com/embed/RaA9elSYnpQ","https://encrypted-tbn0.gstatic.com/images?q=tbn:ANd9GcSf2dfgX6MEnaRNwWQSyRmKHm53LfBYmW9pJJCfqjE0BKijzycS",36,6.9,8226,1374,6852,"In sagittis dui vel nisl. Duis ac nibh. Fusce lacus purus, aliquet at, feugiat non, pretium quis, lectus.",32,1948,98,2.8,198,3428,-3230
1069,"Clifford",1999,"https://www.youtube.com/embed/i6ilL5z6cjA","https://encrypted-tbn0.gstatic.com/images?q=tbn:ANd9GcT3yd_NJLFNa8pH2NX8GufmbmYJmY751UxjTNcB2ALIMGhKfx94gQ",26,2.4,6579,8004,-1425,"Proin interdum mauris non ligula pellentesque ultrices. Phasellus id sapien in sapien iaculis congue. Vivamus metus arcu, adipiscing molestie, hendrerit at, vulputate vitae, nisl.",26,6159,19,2.9,9899,2999,6900
1070,"Protector (Protektor)",1989,"https://www.youtube.com/embed/fkr_djVWStU","https://encrypted-tbn0.gstatic.com/images?q=tbn:ANd9GcRauFfIne8mHbF9MCn-LxY8C6gHqalPefcj6s8z0B9JZwEnD5A4",11,1.7,8382,2489,5893,"Fusce consequat. Nulla nisl. Nunc nisl.",62,2667,33,4.3,3458,2001,1457
1071,"The Tic Code",2002,"https://www.youtube.com/embed/giIs-AEAX6Y","https://encrypted-tbn0.gstatic.com/images?q=tbn:ANd9GcQInYhbERWHKRlaq1eJAqZqaGQ9zndtpCyGofdPFToPGHuZUGCS",20,5.7,3417,3539,-122,"In sagittis dui vel nisl. Duis ac nibh. Fusce lacus purus, aliquet at, feugiat non, pretium quis, lectus.",86,8838,6,6.1,2481,3421,-940
1072,"Little Giants",2010,"https://www.youtube.com/embed/OWwVD1xdAX4","https://i.pinimg.com/236x/77/50/b3/7750b3ebe0787ae8e9beb7e2615e3b01.jpg",59,6.1,5954,1560,4394,"Proin eu mi. Nulla ac enim. In tempor, turpis nec euismod scelerisque, quam turpis adipiscing lorem, vitae mattis nibh ligula nec sem.",28,5258,56,7.2,2269,8629,-6360
1073,"Joe Kidd",2000,"https://www.youtube.com/embed/Xwzwmc2AZYg","https://encrypted-tbn0.gstatic.com/images?q=tbn:ANd9GcS_NoH0Aw_5YFsBFwfBPn_O7YPHXumI5V3iQ2s7B-3zPU_7sSm1gA",31,8.1,4286,6366,-2080,"Quisque porta volutpat erat. Quisque erat eros, viverra eget, congue eget, semper rutrum, nulla. Nunc purus.",44,4185,78,5.9,9822,1037,8785
1074,"All These Women (För att inte tala om alla dessa kvinnor)",1987,"https://www.youtube.com/embed/ka3J1sUhQ4M","https://encrypted-tbn0.gstatic.com/images?q=tbn:ANd9GcToWUNrpDN1sKiQrTBrAPVZaaHkjYWkdwsMh5Igburh2w20IPRs",31,2.4,7256,4,7252,"Cum sociis natoque penatibus et magnis dis parturient montes, nascetur ridiculus mus. Vivamus vestibulum sagittis sapien. Cum sociis natoque penatibus et magnis dis parturient montes, nascetur ridiculus mus.",80,458,44,4.8,118,5284,-5166
1075,"The King",1985,"https://www.youtube.com/embed/eqDHqOcXjRQ","https://encrypted-tbn0.gstatic.com/images?q=tbn:ANd9GcTppyYABMyqegOc4I6b3NS0iUaX0R6Cy1-PlahMrPPUzzqPNux9Gg",80,1.2,9585,1214,8371,"Proin eu mi. Nulla ac enim. In tempor, turpis nec euismod scelerisque, quam turpis adipiscing lorem, vitae mattis nibh ligula nec sem.",70,9885,80,5.1,7146,1733,5413
1076,"Lust for Gold",2010,"https://www.youtube.com/embed/7C2Nad0aMPg","https://encrypted-tbn0.gstatic.com/images?q=tbn:ANd9GcQ-Bo62SqPu_RKYOfA9eW-LQjqldSZ02v2_G5-UJtSlr8Qd948lLA",81,1.2,8301,156,8145,"Quisque id justo sit amet sapien dignissim vestibulum. Vestibulum ante ipsum primis in faucibus orci luctus et ultrices posuere cubilia Curae; Nulla dapibus dolor vel est. Donec odio justo, sollicitudin ut, suscipit a, feugiat et, eros.",98,6113,65,4.3,8377,1214,7163
1077,"Azumi 2: Death or Love",2006,"https://www.youtube.com/embed/7C2Nad0aMPg","https://encrypted-tbn0.gstatic.com/images?q=tbn:ANd9GcT5qYZ7WL1XpLSuZms35fvGdxwAwN8ZoDje7zRyyFHfFSsWWAHelQ",31,3.4,9585,2596,6989,"Sed ante. Vivamus tortor. Duis mattis egestas metus.",32,8039,11,7.8,5529,7659,-2130
1078,"All These Women (För att inte tala om alla dessa kvinnor)",1993,"https://www.youtube.com/embed/Bn9iowpSWRs","https://encrypted-tbn0.gstatic.com/images?q=tbn:ANd9GcSC_qEbYtBeELogQVPTeiWNRbcOXlYKbMYmMPaG67T_yrWKEiTV",31,5.1,8226,213,8013,"Donec diam neque, vestibulum eget, vulputate ut, ultrices vel, augue. Vestibulum ante ipsum primis in faucibus orci luctus et ultrices posuere cubilia Curae; Donec pharetra, magna vestibulum aliquet ultrices, erat tortor sollicitudin mi, sit amet lobortis sapien sapien non mi. Integer ac neque.",62,7592,26,2.8,8226,2711,5515
1079,"Quand je serai petit",1992,"https://www.youtube.com/embed/MpJEOpsVWtA","https://encrypted-tbn0.gstatic.com/images?q=tbn:ANd9GcT5qYZ7WL1XpLSuZms35fvGdxwAwN8ZoDje7zRyyFHfFSsWWAHelQ",48,1.2,7383,1733,5650,"Quisque id justo sit amet sapien dignissim vestibulum. Vestibulum ante ipsum primis in faucibus orci luctus et ultrices posuere cubilia Curae; Nulla dapibus dolor vel est. Donec odio justo, sollicitudin ut, suscipit a, feugiat et, eros.",80,4526,4,9.1,9122,1560,7562
1080,"Edmond",1998,"https://www.youtube.com/embed/eqDHqOcXjRQ","https://encrypted-tbn0.gstatic.com/images?q=tbn:ANd9GcR_EXv1N1pkhMX0O3KAJXlTgC0_KL4WpSRDxUzH2CO9RPypuvxDAw",89,6.7,7162,285,6877,"Proin eu mi. Nulla ac enim. In tempor, turpis nec euismod scelerisque, quam turpis adipiscing lorem, vitae mattis nibh ligula nec sem.",66,2682,20,1.2,8454,6554,1900
1081,"Protector (Protektor)",1999,"https://www.youtube.com/embed/IU3xV9ZRYlk","https://i.pinimg.com/originals/c9/ba/74/c9ba7451301a9003752d2f61b5036730.jpg",30,9,8454,7219,1235,"Sed sagittis. Nam congue, risus semper porta volutpat, quam pede lobortis ligula, sit amet eleifend pede libero quis orci. Nullam molestie nibh in lectus.",32,4091,78,3.4,6386,627,5759
1082,"Isolation",1985,"https://www.youtube.com/embed/KbZ3TVEkuDY","https://encrypted-tbn0.gstatic.com/images?q=tbn:ANd9GcS5gl0DLTFbt7bYHEmtfUaWEKVmT1jfD8Td6ILXO_YOKSFekX9e",4,3.2,5160,1037,4123,"Cras mi pede, malesuada in, imperdiet et, commodo vulputate, justo. In blandit ultrices enim. Lorem ipsum dolor sit amet, consectetuer adipiscing elit.",22,6139,69,5.9,6662,176,6486
1083,"Edmond",2008,"https://www.youtube.com/embed/B12REtkl2KY","https://encrypted-tbn0.gstatic.com/images?q=tbn:ANd9GcQvLz9_jwOs-MucEN-bWUhjq9aaYyfVvyNoFoGgGFdFJBMuXq1yqw",95,4.3,2883,2001,882,"Pellentesque at nulla. Suspendisse potenti. Cras in purus eu magna vulputate luctus.",68,7690,83,8.1,2323,305,2018
1084,"Man Is Not a Bird (Covek nije tica)",2009,"https://www.youtube.com/embed/3_bUymlkSuA","https://encrypted-tbn0.gstatic.com/images?q=tbn:ANd9GcSOWY9FWNsfX_XrmFypiMILLGG-QtrQcxL8f5w3qsIiNjiSdC3x",23,5.1,8429,8004,425,"Curabitur in libero ut massa volutpat convallis. Morbi odio odio, elementum eu, interdum eu, tincidunt in, leo. Maecenas pulvinar lobortis est.",98,7069,56,2.9,698,2777,-2079
1085,"Iceberg, L'",1997,"https://www.youtube.com/embed/DyQ8PoBV_Vo","https://encrypted-tbn0.gstatic.com/images?q=tbn:ANd9GcS_NoH0Aw_5YFsBFwfBPn_O7YPHXumI5V3iQ2s7B-3zPU_7sSm1gA",66,8.4,9416,5471,3945,"Cum sociis natoque penatibus et magnis dis parturient montes, nascetur ridiculus mus. Vivamus vestibulum sagittis sapien. Cum sociis natoque penatibus et magnis dis parturient montes, nascetur ridiculus mus.",28,2789,34,9,4108,4712,-604
1086,"Little Boy Blue",2010,"https://www.youtube.com/embed/ocWpGdITSR4","http://pictify.saatchigallery.com/files/works/chagall-vitraux-pour-jerusalem-poster-chagall-la-tribu-de-1363528645.jpg",66,2.1,7146,772,6374,"Proin eu mi. Nulla ac enim. In tempor, turpis nec euismod scelerisque, quam turpis adipiscing lorem, vitae mattis nibh ligula nec sem.",64,8013,30,3.8,4324,1733,2591
1087,"Harry Potter and the Order of the Phoenix",2005,"https://www.youtube.com/embed/2FbDY0MeJf8","https://encrypted-tbn0.gstatic.com/images?q=tbn:ANd9GcSQ-QvEfMwKoUuWLDF2x2M1V4BTEN6-uoYrr8ShYvdSVQcHru6h",60,7.7,2409,4860,-2451,"Cum sociis natoque penatibus et magnis dis parturient montes, nascetur ridiculus mus. Vivamus vestibulum sagittis sapien. Cum sociis natoque penatibus et magnis dis parturient montes, nascetur ridiculus mus.",50,6113,11,2,6072,1592,4480
1088,"Level Five",2005,"https://www.youtube.com/embed/ee1172yeqyE","https://encrypted-tbn0.gstatic.com/images?q=tbn:ANd9GcSfenuQRjGbddBAE4j3I_GN73Ch-EI9uairOfxWWbLQYAluLoDWCQ",70,5.1,3890,831,3059,"Fusce consequat. Nulla nisl. Nunc nisl.",86,25,7,1,2269,2308,-39
1089,"Zatoichi the Outlaw (Zatôichi rôyaburi) (Zatôichi 16)",2010,"https://www.youtube.com/embed/8W6yYBAUxv4","https://encrypted-tbn0.gstatic.com/images?q=tbn:ANd9GcSYy4S-T_nbr708KkpYcV-RgmyX_MPtCXzFVr44X7S9CAQsyQAE3Q",66,8.4,3624,6892,-3268,"Proin leo odio, porttitor id, consequat in, consequat ut, nulla. Sed accumsan felis. Ut at dolor quis odio consequat varius.",100,2789,59,5.1,7393,5515,1878
1090,"Block-Heads",1979,"https://www.youtube.com/embed/VccwBGgyzP4","https://encrypted-tbn0.gstatic.com/images?q=tbn:ANd9GcSZ6r6rDjMvQsp22jqT0ZPe_z-oKhAWQcjwgB5egzck4lqzLHYHCg",44,4.2,5542,2489,3053,"Phasellus in felis. Donec semper sapien a libero. Nam dui.",80,1882,9,3.1,2409,3412,-1003
1091,"Iceberg, L'",1998,"https://www.youtube.com/embed/iOMxsy8S7hk","https://encrypted-tbn0.gstatic.com/images?q=tbn:ANd9GcT8fsnqcp8Y3Y2dxkM4H8TJyS7bRYttijiNFZ-mruoqpzO29uM7",89,3.4,8446,3421,5025,"Donec diam neque, vestibulum eget, vulputate ut, ultrices vel, augue. Vestibulum ante ipsum primis in faucibus orci luctus et ultrices posuere cubilia Curae; Donec pharetra, magna vestibulum aliquet ultrices, erat tortor sollicitudin mi, sit amet lobortis sapien sapien non mi. Integer ac neque.",44,5615,13,3.2,6386,831,5555
1092,"Second Wind (Le deuxième souffle) (Second Breath)",2002,"https://www.youtube.com/embed/78ozCL4sQoI","https://encrypted-tbn0.gstatic.com/images?q=tbn:ANd9GcTrBuPeRIXbqvHjWMwFg1aZvVkw71rsNVla5A067w7kiY-DPB7N",38,6,2847,898,1949,"Donec diam neque, vestibulum eget, vulputate ut, ultrices vel, augue. Vestibulum ante ipsum primis in faucibus orci luctus et ultrices posuere cubilia Curae; Donec pharetra, magna vestibulum aliquet ultrices, erat tortor sollicitudin mi, sit amet lobortis sapien sapien non mi. Integer ac neque.",80,8851,28,6.3,5160,1898,3262
1093,"Miami Vice",1987,"https://www.youtube.com/embed/2FbDY0MeJf8","https://encrypted-tbn0.gstatic.com/images?q=tbn:ANd9GcSaZZLwGXqiNU5rkhexU86wKZGzymZWTp2nKRDFdITh7rD7Jb6yGA",6,2.9,4286,3421,865,"Suspendisse potenti. In eleifend quam a odio. In hac habitasse platea dictumst.",82,1882,6,2.8,8410,5284,3126
1094,"The King",2012,"https://www.youtube.com/embed/vuzplFd3YVY","https://encrypted-tbn0.gstatic.com/images?q=tbn:ANd9GcRWaaeSy6yTdILVOdHiDa9DWFAM4DhQ1JlJvUBR4vWbVoeZznD-",48,5.9,9683,3428,6255,"Pellentesque at nulla. Suspendisse potenti. Cras in purus eu magna vulputate luctus.",62,9885,38,1.8,2779,898,1881
1095,"Vicky Donor",2010,"https://www.youtube.com/embed/tkSuLa3o_5A","https://encrypted-tbn0.gstatic.com/images?q=tbn:ANd9GcToWUNrpDN1sKiQrTBrAPVZaaHkjYWkdwsMh5Igburh2w20IPRs",68,7.7,5954,537,5417,"Curabitur in libero ut massa volutpat convallis. Morbi odio odio, elementum eu, interdum eu, tincidunt in, leo. Maecenas pulvinar lobortis est.",88,9382,48,5.1,1191,8004,-6813
1096,"Isolation",1991,"https://www.youtube.com/embed/iOMxsy8S7hk","https://encrypted-tbn0.gstatic.com/images?q=tbn:ANd9GcQKE0-ggtSuRrbc-0BlaVgTBu4zGwn22cMB8tEdwr9uHJJ9jXGs",88,8.3,7256,2617,4639,"Mauris enim leo, rhoncus sed, vestibulum sit amet, cursus id, turpis. Integer aliquet, massa id lobortis convallis, tortor risus dapibus augue, vel accumsan tellus nisi eu orci. Mauris lacinia sapien quis libero.",30,7612,55,5.7,6175,285,5890
1097,"Another Woman",1997,"https://www.youtube.com/embed/_c3WIprIGHE","https://encrypted-tbn0.gstatic.com/images?q=tbn:ANd9GcQKE0-ggtSuRrbc-0BlaVgTBu4zGwn22cMB8tEdwr9uHJJ9jXGs",22,3.2,2847,3771,-924,"Praesent blandit. Nam nulla. Integer pede justo, lacinia eget, tincidunt eget, tempus vel, pede.",30,735,26,4.2,2481,898,1583
1098,"Hype!",2006,"https://www.youtube.com/embed/iW3t_wUDG5U","https://encrypted-tbn0.gstatic.com/images?q=tbn:ANd9GcQvfJ-vLQ5TK13ND8sY6H-r6cm_4f3SnW_WAWn2vuX-nGh6F8JquQ",44,1.1,9683,1061,8622,"Quisque porta volutpat erat. Quisque erat eros, viverra eget, congue eget, semper rutrum, nulla. Nunc purus.",74,1620,78,8.4,8429,6892,1537
1099,"Wing and a Prayer",1987,"https://www.youtube.com/embed/l-u3PdA-rpY","https://encrypted-tbn0.gstatic.com/images?q=tbn:ANd9GcSZ6r6rDjMvQsp22jqT0ZPe_z-oKhAWQcjwgB5egzck4lqzLHYHCg",34,2.4,8715,3648,5067,"Praesent blandit. Nam nulla. Integer pede justo, lacinia eget, tincidunt eget, tempus vel, pede.",62,6858,36,6.9,9416,5284,4132
1100,"Protector (Protektor)",1994,"https://www.youtube.com/embed/iM8kaNCrnX0","https://encrypted-tbn0.gstatic.com/images?q=tbn:ANd9GcSi9aOrS5oPJ7A3vLqJaEpNsmPCxVAYNwpoAl_G9K7p6pLBjaxALw",70,9.3,3923,8629,-4706,"Cras non velit nec nisi vulputate nonummy. Maecenas tincidunt lacus at velit. Vivamus vel nulla eget eros elementum pellentesque.",62,1636,70,3.2,6072,1592,4480
1101,"All These Women (För att inte tala om alla dessa kvinnor)",2002,"https://www.youtube.com/embed/vuzplFd3YVY","https://encrypted-tbn0.gstatic.com/images?q=tbn:ANd9GcRUMZIkgEW4ZtYyXTgo6uGdYksy7dreOkd-zJRc1uGna-GAnU3SDQ",80,8.4,6734,3118,3616,"Quisque porta volutpat erat. Quisque erat eros, viverra eget, congue eget, semper rutrum, nulla. Nunc purus.",52,223,6,1.5,7762,3881,3881
1102,"Clifford",1994,"https://www.youtube.com/embed/QJlh0IPQbbo","https://encrypted-tbn0.gstatic.com/images?q=tbn:ANd9GcQzrbGfcJ8GKN78hn-r1fcQf4zH81e0MlsuOddkBJvhC5RvfF2DNw",66,9.3,3801,3771,30,"Fusce posuere felis sed lacus. Morbi sem mauris, laoreet ut, rhoncus aliquet, pulvinar sed, nisl. Nunc rhoncus dui vel sem.",96,1277,61,4.9,6006,3313,2693
1103,"Thoroughly Modern Millie",2010,"https://www.youtube.com/embed/oNTzFnMXT3E","https://encrypted-tbn0.gstatic.com/images?q=tbn:ANd9GcSf2dfgX6MEnaRNwWQSyRmKHm53LfBYmW9pJJCfqjE0BKijzycS",40,7.2,5498,1733,3765,"Sed sagittis. Nam congue, risus semper porta volutpat, quam pede lobortis ligula, sit amet eleifend pede libero quis orci. Nullam molestie nibh in lectus.",48,4526,42,5.1,8446,2999,5447
1104,"Another Woman",2000,"https://www.youtube.com/embed/qSs5zsGoqs4","https://i.pinimg.com/236x/77/50/b3/7750b3ebe0787ae8e9beb7e2615e3b01.jpg",56,9.5,12,215,-203,"Curabitur at ipsum ac tellus semper interdum. Mauris ullamcorper purus sit amet nulla. Quisque arcu libero, rutrum ac, lobortis vel, dapibus at, diam.",22,3441,25,9.7,5943,215,5728
1105,"U2: Rattle and Hum",1999,"https://www.youtube.com/embed/1ywA8TtwJ50","https://encrypted-tbn0.gstatic.com/images?q=tbn:ANd9GcQzrbGfcJ8GKN78hn-r1fcQf4zH81e0MlsuOddkBJvhC5RvfF2DNw",57,6.8,1795,562,1233,"In congue. Etiam justo. Etiam pretium iaculis justo.",62,1528,80,9.3,8437,5471,2966
1106,"Dragon Ball Z the Movie: The World's Strongest (a.k.a. Dragon Ball Z: The Strongest Guy in The World) (Doragon bôru Z: Kono yo de ichiban tsuyoi yatsu)",2010,"https://www.youtube.com/embed/VccwBGgyzP4","https://encrypted-tbn0.gstatic.com/images?q=tbn:ANd9GcSC_qEbYtBeELogQVPTeiWNRbcOXlYKbMYmMPaG67T_yrWKEiTV",56,5.1,2409,1575,834,"Cras non velit nec nisi vulputate nonummy. Maecenas tincidunt lacus at velit. Vivamus vel nulla eget eros elementum pellentesque.",48,6632,22,2.8,5146,5209,-63
1107,"Vicky Donor",1999,"https://www.youtube.com/embed/eqDHqOcXjRQ","https://encrypted-tbn0.gstatic.com/images?q=tbn:ANd9GcR_EXv1N1pkhMX0O3KAJXlTgC0_KL4WpSRDxUzH2CO9RPypuvxDAw",22,1.8,4324,1560,2764,"Morbi non lectus. Aliquam sit amet diam in magna bibendum imperdiet. Nullam orci pede, venenatis non, sodales sed, tincidunt eu, felis.",70,7069,81,7.8,8715,2198,6517
1108,"Escaflowne: The Movie (Escaflowne)",2010,"https://www.youtube.com/embed/BQcvHEkGaEA","https://encrypted-tbn0.gstatic.com/images?q=tbn:ANd9GcSBKrAU7qHXZ_vqij5HmW3xvTgSZ9qA7lT4fxAsUEXHGvWHHXai",26,2.9,7715,156,7559,"Cum sociis natoque penatibus et magnis dis parturient montes, nascetur ridiculus mus. Vivamus vestibulum sagittis sapien. Cum sociis natoque penatibus et magnis dis parturient montes, nascetur ridiculus mus.",64,4526,42,3.8,2987,73,2914
1109,"Little Giants",1998,"https://www.youtube.com/embed/eAIjuMHKEiA","https://encrypted-tbn0.gstatic.com/images?q=tbn:ANd9GcQX7g7WDTuGnT2syPcShrXK1gFJn4uMaACeAnWvesheIZXX58K1",89,2.8,8410,2240,6170,"Pellentesque at nulla. Suspendisse potenti. Cras in purus eu magna vulputate luctus.",26,2435,95,1.2,5954,3607,2347
1110,"Blow Out",1997,"https://www.youtube.com/embed/2BoyDp49C6Y","https://encrypted-tbn0.gstatic.com/images?q=tbn:ANd9GcSkP7ePajJciblvooQK7qTSV2J0ZdjBzPxrRi7NvBHdmOLYWeT4",31,7.8,2883,1741,1142,"Phasellus sit amet erat. Nulla tempus. Vivamus in felis eu sapien cursus vestibulum.",28,25,24,1.1,198,1496,-1298
1111,"Diary of a Shinjuku Thief (Shinjuku dorobo nikki)",1999,"https://www.youtube.com/embed/HwWWws3kzKg","https://encrypted-tbn0.gstatic.com/images?q=tbn:ANd9GcQInYhbERWHKRlaq1eJAqZqaGQ9zndtpCyGofdPFToPGHuZUGCS",98,8.1,8388,73,8315,"Proin interdum mauris non ligula pellentesque ultrices. Phasellus id sapien in sapien iaculis congue. Vivamus metus arcu, adipiscing molestie, hendrerit at, vulputate vitae, nisl.",90,3074,18,6,8437,1214,7223
1112,"The Prisoner",1997,"https://www.youtube.com/embed/THq6KlWgiqw","https://encrypted-tbn0.gstatic.com/images?q=tbn:ANd9GcS_NoH0Aw_5YFsBFwfBPn_O7YPHXumI5V3iQ2s7B-3zPU_7sSm1gA",13,1.5,3458,8964,-5506,"Sed ante. Vivamus tortor. Duis mattis egestas metus.",62,2667,56,9.6,5529,3251,2278
1113,"From Beijing with Love",2007,"https://www.youtube.com/embed/B12REtkl2KY","https://encrypted-tbn0.gstatic.com/images?q=tbn:ANd9GcSflOt4SdSx3LCTNP7im_XpsqHeeK_V_ltLPZEnK4mLjl4Eja_t",18,7.7,6662,3539,3123,"Maecenas leo odio, condimentum id, luctus nec, molestie sed, justo. Pellentesque viverra pede ac diam. Cras pellentesque volutpat dui.",76,2682,13,4.4,6006,2198,3808
1114,"The Pit, the Pendulum and Hope",2009,"https://www.youtube.com/embed/MpJEOpsVWtA","https://encrypted-tbn0.gstatic.com/images?q=tbn:ANd9GcSflOt4SdSx3LCTNP7im_XpsqHeeK_V_ltLPZEnK4mLjl4Eja_t",95,3.4,7683,1560,6123,"Proin eu mi. Nulla ac enim. In tempor, turpis nec euismod scelerisque, quam turpis adipiscing lorem, vitae mattis nibh ligula nec sem.",68,7146,56,8.9,9416,225,9191
1115,"Card Subject To Change",2006,"https://www.youtube.com/embed/uaTAhjdaEuY","https://encrypted-tbn0.gstatic.com/images?q=tbn:ANd9GcRUlnvuLTJg0mT65nGxwZY6OfVvev6DxlvShy5w5Mpai-i6Vk6Qfg",24,4.3,8496,2240,6256,"Quisque porta volutpat erat. Quisque erat eros, viverra eget, congue eget, semper rutrum, nulla. Nunc purus.",68,5537,35,9.3,9389,305,9084
1116,"The Cell 2",1986,"https://www.youtube.com/embed/LO9I2fpyUyg","https://encrypted-tbn0.gstatic.com/images?q=tbn:ANd9GcToWUNrpDN1sKiQrTBrAPVZaaHkjYWkdwsMh5Igburh2w20IPRs",65,5.9,5542,2711,2831,"Fusce consequat. Nulla nisl. Nunc nisl.",58,93,31,4.2,4324,4020,304
1117,"Another Woman",2011,"https://www.youtube.com/embed/Bn9iowpSWRs","https://encrypted-tbn0.gstatic.com/images?q=tbn:ANd9GcRTcG2_JqWMZJOf6uyZm7vI1GQGSsjWkKgxCokuA40pthaOj9LOFQ",28,6.8,6734,2311,4423,"Proin eu mi. Nulla ac enim. In tempor, turpis nec euismod scelerisque, quam turpis adipiscing lorem, vitae mattis nibh ligula nec sem.",84,2629,29,3.1,2409,8964,-6555
1118,"Overnight Delivery",1989,"https://www.youtube.com/embed/SF0w2B6DNUE","https://encrypted-tbn0.gstatic.com/images?q=tbn:ANd9GcTVx6QbLHPUKkVSj1TkaOANhnRfjtIXHhKnHSaIR2y3RkCgry-X",19,1,2987,361,2626,"Praesent blandit. Nam nulla. Integer pede justo, lacinia eget, tincidunt eget, tempus vel, pede.",42,694,78,6.7,1191,3074,-1883
1119,"Fido",2010,"https://www.youtube.com/embed/6SO96lvWqzc","https://encrypted-tbn0.gstatic.com/images?q=tbn:ANd9GcQKE0-ggtSuRrbc-0BlaVgTBu4zGwn22cMB8tEdwr9uHJJ9jXGs",19,1.8,4286,4020,266,"Cras mi pede, malesuada in, imperdiet et, commodo vulputate, justo. In blandit ultrices enim. Lorem ipsum dolor sit amet, consectetuer adipiscing elit.",30,4869,70,9.5,132,2352,-2220
1120,"Sky Fighters (Les Chevaliers Du Ciel)",2008,"https://www.youtube.com/embed/7C2Nad0aMPg","https://encrypted-tbn0.gstatic.com/images?q=tbn:ANd9GcSOWY9FWNsfX_XrmFypiMILLGG-QtrQcxL8f5w3qsIiNjiSdC3x",64,6.9,5704,1733,3971,"In hac habitasse platea dictumst. Etiam faucibus cursus urna. Ut tellus.",44,2413,84,4.9,9416,3313,6103